PRRRPRRRPRRRPRRRPRRRPRRRPRRRPRRRPRRRPRRRPRRRPRRRPRRRPRRRPRRRPRPPPPPPPPSSSSSSSSSSSSSSSSSSSSSSSSSSSSSSSSSSSSSSSSSSSSSSSSSSSSSSSSSS
PRRRPRRRPRRRPRRRPRRRPRRRPRRRPRRRPRRRPRRRPRRRPRRRPRRRPRRRPRRRPRRRPPPPPPPPPPPPPPPPPPPPPPPPPPPPPPPPPPPPPPSSSSSSSSSSSSSSSSSSSSSSSSSS
PRRRPRRRPRRRPRRRPRRRPRRRPRRRPRRRPRRRPRRRPRRRPRRRPRRRPRRRPRRPPPPPPPPPPPPSSSSSSSSSSSSSSSSSSSSSSSSSSSSSSSSSSSSSSSSSSSSSSSSSSSSSSSSS
PRRRPRRRPRRRPRRRPRRRPRRRPRRRPRRRPRRRPPPPPPPPPPPPPPPPPPPPPPPPPPPPPPPPPPPPPPPPPPPPSSSSSSSSSSSSSSSSSSSSSSSSSSSSSSSSSSSSSSSSSSSSSSSS
PRRRPRRRPRRRPRRRPRRRPRRRPRRRPRRRPRRRPRRRPRRRPRRRPRRRPRRRPRRRPRRRPPPPPPPPPPPPPPPPPPPPPPPPSSSSSSSSSSSSSSSSSSSSSSSSSSSSSSSSSSSSSSSS
PRRRPRRRPRRRPRRRPRRRPRRRPRRRPRRRPRRRPRRRPRRRPRRRPRRRPRRRPRRRPRRRPRRRPRRRPRRRPRRRPRRRPRRRPRRRPRRRPRRRPRRRPRRRPPPSSSSSSSSSSSSSSSSS
PRRRPRPPPPPPPPPPPPPPPPPPPPPPPPPPPPPPPPPSSSSSSSSSSSSSSSSSSSSSSSSSSSSSSSSSSSSSSSSSSSSSSSSSSSSSSSSSSSSSSSSSSSSSSSSSSSSSSSSSSSSSSSSS
PRRRPRRRPRRRPRRRPRRRPRRRPRRRPRRRPRRRPRRRPRRRPRRRPRRRPRRRPRRRPRRRPRRRPRRRPPPPPPPPPPPPPPPPPPPPPPPPPPPPPSSSSSSSSSSSSSSSSSSSSSSSSSSS
PRRRPRRRPPPPPPPPPPPPPPPPPPPPPPPPPPPPPPPPPPPPPPPPPPPPPPPPPPPPPPPPPPPPPPPPPPPPPPPPPPPPPPPPPPPPPPPPPPPPPPPPPPPPPPPPPPPPPSSSSSSSSSSS
PRRRPRRRPRRRPRRRPRRRPRRRPRRRPRRRPRRRPRRRPRRRPPPPPPPPPPPPPPPPPPPPPPPPPPPPPPPPPPPPPPPPPPPPPPPPPPPPPPPPPPPPPPPPPPPPPPPPPPPPSSSSSSSS
PRRRPRRRPRRRPRRRPRRRPRRRPRRRPRRRPRRRPRRRPRRRPRRRPRRRPRRRPRRPPPPPPPPSSSSSSSSSSSSSSSSSSSSSSSSSSSSSSSSSSSSSSSSSSSSSSSSSSSSSSSSSSSSS
PRRRPRRRPRRRPRRRPRRRPRRRPRRRPRRRPRRRPRRRPRRRPRRRPRRRPRRRPRRRPRRRPRRRPRRPPPPPPPPPPPPPPPPPPPPPPPPPSSSSSSSSSSSSSSSSSSSSSSSSSSSSSSSS
PRRRPRRRPRRRPRRRPRRRPRRRPRPPPPPPPPPPPPPPPPPPPPPPPPPPPPPPPSSSSSSSSSSSSSSSSSSSSSSSSSSSSSSSSSSSSSSSSSSSSSSSSSSSSSSSSSSSSSSSSSSSSSSS
PRRRPRRRPRRRPRRRPRRRPRRRPRRRPRRRPRPPPPPPPPPPPPPPPPPPPPPPPPPPPPPPPPSSSSSSSSSSSSSSSSSSSSSSSSSSSSSSSSSSSSSSSSSSSSSSSSSSSSSSSSSSSSSS
PRRRPRRRPRRRPRRRPRRRPRPPPPPPPPPPPPPPPPPPPPPPPPPPPPPPPPPPPPPPPPPPPPPPPPPPPPPPPPPPPPSSSSSSSSSSSSSSSSSSSSSSSSSSSSSSSSSSSSSSSSSSSSSS
PRRRPRRRPRRRPRRRPRRRPRRRPRRRPRRRPRRRPRRRPRRRPRRRPRRRPRRRPRRRPPPPPPPPPPPPPPPPPPPPPPPPPPPPPPPPPPPPPPPPPPPPPPPPPPPPPPPPPPSSSSSSSSSS
PRRRPRRRPPPPPPPPPPPPPPPPPPPPPPPPPPPPPPPPPPPPPPPPPPPPPPPPPPPPPPPPPPPPPPPPPPPPPPPPPPPPPPPPPPPPPPPPPPPPPPPPPPPPPPPPPPPPPPPPPPPPSSSS
PRRRPRRRPRRRPRRRPRRRPRRRPRRRPRRRPRRRPRRRPRRRPRRRPRRRPRRRPRRRPRRRPRRRPRRRPRRRPRRRPRRRPRRRPRRRPRRRPRRRPRPPPPPPPPPPPSSSSSSSSSSSSSSS
PRRRPRPPPPPPPPPPPPPPPPPPPPPPPPPPPPPPPPPPPPPPPPPPPPPPPPPPPPPPSSSSSSSSSSSSSSSSSSSSSSSSSSSSSSSSSSSSSSSSSSSSSSSSSSSSSSSSSSSSSSSSSSSS
PRRRPRRRPRRRPRRRPRRRPRRRPRRRPRRRPRRRPRRRPRRRPRRRPRRRPRRRPPPPPPPPPPPPPPPPPPPSSSSSSSSSSSSSSSSSSSSSSSSSSSSSSSSSSSSSSSSSSSSSSSSSSSSS
PRRRPRRRPRRRPRRRPRRRPRRRPRRRPRRRPRRRPRRRPRRRPPPPPPPPPPSSSSSSSSSSSSSSSSSSSSSSSSSSSSSSSSSSSSSSSSSSSSSSSSSSSSSSSSSSSSSSSSSSSSSSSSSS
PRRRPRRRPRRRPRRRPRRRPRRRPRRRPRRRPRRRPRRRPRRRPRRRPRRRPRRRPRRRPRRRPRRRPRRRPRRRPRRRPRRPPPPPPPPPPPPPSSSSSSSSSSSSSSSSSSSSSSSSSSSSSSSS
PRRRPRRPPPPPPPPPPPPPPPPPPPPPPPPPPPPPPPPPPPPPPPPPPPPPPPPPPPPPPPPPPPPPPPPPPPPPPPPPPPPPPPPPPPPPPPPPSSSSSSSSSSSSSSSSSSSSSSSSSSSSSSSS
PRRRPRRRPRRRPRRRPRRRPRRPPPPPPPPPPPPPPPPPPPPPPPPPPPPPPPPPPPPPPPPPPPPPPPPPPPPPPPPPPPPPPPPPPPPPPPPPPPPSSSSSSSSSSSSSSSSSSSSSSSSSSSSS
PRRRPRRRPRRRPRRRPPPPPPPPPPPPPPPPPPPPPPPPPPPPPPPPPPPPPPPPPPPSSSSSSSSSSSSSSSSSSSSSSSSSSSSSSSSSSSSSSSSSSSSSSSSSSSSSSSSSSSSSSSSSSSSS
PRRRPRRRPRRRPRRRPRRRPRRRPRRRPRRRPRRRPRRRPRRRPRRRPRRRPRRRPRRRPRRRPRRRPRRRPRRRPRRRPRRPPPPPPPPPPPPPPPPPPPPPPPPPPPPSSSSSSSSSSSSSSSSS
PRRRPRRRPRRRPRRRPRRRPRRRPRRRPRRRPRRRPRRRPRRRPRRRPRRRPRRRPRRRPRRRPRRRPRRRPRRRPRRRPRRRPPPPPPPPPPPPPPPPPPPSSSSSSSSSSSSSSSSSSSSSSSSS
PRRRPRRRPRRRPRRRPRRRPRRRPRRRPRRRPRRRPRRRPRRRPRRRPRRRPRRRPRRRPRRRPRRRPRRRPRRRPRRRPRRRPRRRPRRPPPPPPPPPSSSSSSSSSSSSSSSSSSSSSSSSSSSS
PRRRPRRRPRRRPRRRPRRRPRRRPRRRPRRRPRRRPRRRPRRRPRRRPRRRPRRRPRRRPRRRPRRRPRRRPRRPPPPPPPPPPSSSSSSSSSSSSSSSSSSSSSSSSSSSSSSSSSSSSSSSSSSS
PRRRPRRRPRRRPRRPPPPPPPPPPPPPPSSSSSSSSSSSSSSSSSSSSSSSSSSSSSSSSSSSSSSSSSSSSSSSSSSSSSSSSSSSSSSSSSSSSSSSSSSSSSSSSSSSSSSSSSSSSSSSSSSS
PRRRPRRRPRRRPRRRPRRRPRRRPRRRPRRRPRRRPRRRPRRRPRRRPRRRPRRRPRRRPRRRPRRRPRRRPRRRPRRRPRRRPRRRPRRRPRRRPRRRPRRRPRRRPRRRPRRRPRSSSSSSSSSS
PRRRPRRRPRRRPRRRPRRRPRRPPSSSSSSSSSSSSSSSSSSSSSSSSSSSSSSSSSSSSSSSSSSSSSSSSSSSSSSSSSSSSSSSSSSSSSSSSSSSSSSSSSSSSSSSSSSSSSSSSSSSSSSS
PRRRPRRRPRRRPRRRPRRRPRRRPRRRPRRRPRRRPPPPPSSSSSSSSSSSSSSSSSSSSSSSSSSSSSSSSSSSSSSSSSSSSSSSSSSSSSSSSSSSSSSSSSSSSSSSSSSSSSSSSSSSSSSS
PRRRPRRRPRRRPRRRPRRRPRRRPRRRPRRRPRPPPPPPPPPPPPPPPPPPPPPPPPPSSSSSSSSSSSSSSSSSSSSSSSSSSSSSSSSSSSSSSSSSSSSSSSSSSSSSSSSSSSSSSSSSSSSS
PRRRPRRRPRRRPRPPPPPPPPPPPPPPPPPPPPPPPPPPPPPPPPPPPPPPPPPPPPPPPPPPPPPPPPPPPPPPPPPPPPSSSSSSSSSSSSSSSSSSSSSSSSSSSSSSSSSSSSSSSSSSSSSS
PRRRPRRRPRRRPRRRPRRRPRRRPRRRPRRRPRRRPRRRPRRPPPPPPPPPPPPPPPPPPPPPPPPPPPPPPPPPPPPPPPPPPPPPPPPPPPPPPPPPPPPPPPPSSSSSSSSSSSSSSSSSSSSS
PRRRPRRRPRRRPRRRPRRRPPPPPPPPPPPPPPPPPPPPPPPPPPPPPPPPPPPPPPPPPPPPPPPPPPPPPPPPPPPPPPPPPPPPPPPPPPPPPPPPPPPPPPPPPSSSSSSSSSSSSSSSSSSS
PRRRPRRRPRRRPRRRPRRRPRRRPRRRPRRRPRRPPPPPPPPPPPPPPPPPPPPPPPPPPPPSSSSSSSSSSSSSSSSSSSSSSSSSSSSSSSSSSSSSSSSSSSSSSSSSSSSSSSSSSSSSSSSS
PRRRPRRRPRRRPRRRPRRRPRRRPRRRPRRRPRRRPRRRPRRRPPPPPPPPPPPPPPPPPPPPPPPPPPPPPPPPPPPPPPPPPPPPPPPPPPPSSSSSSSSSSSSSSSSSSSSSSSSSSSSSSSSS
PRRRPRRRPRRRPRRRPPPPPPPPPPPPPPPPSSSSSSSSSSSSSSSSSSSSSSSSSSSSSSSSSSSSSSSSSSSSSSSSSSSSSSSSSSSSSSSSSSSSSSSSSSSSSSSSSSSSSSSSSSSSSSSS
PRRRPRRRPRRRPRRRPRRRPRRRPRRRPRRRPRRRPRRRPRRRPRRRPRRRPRRRPRRRPRRRPRRRPRRRPRRRPRRRPRRRPRRRPRRPPPPPPPPPPPPPPPPPPPPPPPPPPPPPPPPSSSSS
PRRRPRRRPRPPPPPPPPPPPPPPPPPPPPPPPPPPPPPPPPPPPPPPPPPPPPPSSSSSSSSSSSSSSSSSSSSSSSSSSSSSSSSSSSSSSSSSSSSSSSSSSSSSSSSSSSSSSSSSSSSSSSSS
PRRRPRRRPRRRPRRRPRRRPRRRPRRRPRRRPRRRPRRRPRRRPRRRPRRRPRRRPRRRPRRRPRRRPRRRPRRRPRRRPRRRPRRRPRRRPRRRPRRRPRRRPRRRPRRRPRRRPRRRPRPPSSSS
PRRRPRRRPRRRPRRRPRRRPRRRPRRRPRRRPRRRPRRRPRRRPRRPPPPPPPPPPPPPPPPPPPPPPPPPPPPPPPPPPPPPPPSSSSSSSSSSSSSSSSSSSSSSSSSSSSSSSSSSSSSSSSSS
PRRRPRRRPRRRPRRRPRRRPRRRPRRRPRRRPRRRPRRRPRRRPRRRPRRRPRRRPRRRPRRRPRRRPRRRPRRRPRRRPRRRPRRRPRRRPPPSSSSSSSSSSSSSSSSSSSSSSSSSSSSSSSSS
PRRRPRRRPRRRPRRRPRRRPRRRPRRRPRRRPRRRPRRRPRRRPRRRPRRRPRRRPRRRPRRRPRRRPRRRPRRRPRRRPPPPPPPPPPPPPPPPPPPPPPPPPPPPPSSSSSSSSSSSSSSSSSSS
PRRRPRRRPRRRPRRRPRRRPRRRPRRRPRRRPRRRPRRRPRRPPPPPPPPPPPPPPPPPPPPPPPPPPPPPPPPPPPPPPPPPPPPPPPPPPPPPPPPPPPPPPPPPPPPPPPPPPPPPPPPPPPPS
PRRRPRRRPRRRPRPPPPPPPPPPPPPPPPPPPPSSSSSSSSSSSSSSSSSSSSSSSSSSSSSSSSSSSSSSSSSSSSSSSSSSSSSSSSSSSSSSSSSSSSSSSSSSSSSSSSSSSSSSSSSSSSSS
PRRRPRRRPRRRPRRRPRRRPRRRPRRRPRRRPRRRPRRRPRRRPRRRPRRRPRRRPRRRPRRRPRRRPRRRPRRRPRRRPRPSSSSSSSSSSSSSSSSSSSSSSSSSSSSSSSSSSSSSSSSSSSSS
PRRRPRPPPPPPPPPPPPPPPPPPPPPPPPPPPPPPPPPPPPPPPPPPPPPPPPPPPPPPPPPPPPPPPSSSSSSSSSSSSSSSSSSSSSSSSSSSSSSSSSSSSSSSSSSSSSSSSSSSSSSSSSSS
PRRRPRRRPRRRPRRRPRRRPRPPPPPPPPPPPPPPPPPPSSSSSSSSSSSSSSSSSSSSSSSSSSSSSSSSSSSSSSSSSSSSSSSSSSSSSSSSSSSSSSSSSSSSSSSSSSSSSSSSSSSSSSSS
PRRRPRRRPRRRPRRRPRRRPRRRPRRRPRRRPRRRPRRRPRRRPRRRPRRRPRRRPRRRPRRRPRRRPRRRPRRRPRRRPRRRPPPPPPPPPPPPPPPPSSSSSSSSSSSSSSSSSSSSSSSSSSSS
PRRRPRRRPRRRPRRRPRRRPRRRPRRRPRRRPRRRPRRRPRRRPRRRPRRRPRRRPRRRPRRRPRRRPRRRPRRRPRRRPRRRPPPPPPPPPPPPPPPPPPPPPPPPSSSSSSSSSSSSSSSSSSSS
PRRRPRRRPRRRPRRRPRRRPRRRPRRRPRRRPRRRPRRRPRRRPRRRPRRRPRRRPRRRPRRRPRRRPRRRPRRRPRRRPRRRPRRRPRRRPRRRPRRRPRRRPRRRPRRRPRRRPRRRPRSSSSSS
PRRRPRRRPRRRPRRRPRRRPRRRPRRRPRRRPRRRPRRRPRRRPRRRPRRRPRRRPRRRPRRRPRRRPRRRPRRRPRRRPRRRPRRRPRRRPRRRPRRRPRRRPRRRPRRRPRRRPRRRPRRRPRSS
PRRPPPPPPPPPPPPPPPPPPPPPPPPPPPPPPPPPPPPPPPPPPPPPSSSSSSSSSSSSSSSSSSSSSSSSSSSSSSSSSSSSSSSSSSSSSSSSSSSSSSSSSSSSSSSSSSSSSSSSSSSSSSSS
PRRPPPPPPPPPPPPPPPPPPPPPPPPPPPPPPPPPPPPPPPPPPPPPPPPPPPPPPPSSSSSSSSSSSSSSSSSSSSSSSSSSSSSSSSSSSSSSSSSSSSSSSSSSSSSSSSSSSSSSSSSSSSSS
PRRRPRRRPRRRPRRRPRRRPPPPPPPPPPPPPPPPPPPPPPPPPPPPPPPPPSSSSSSSSSSSSSSSSSSSSSSSSSSSSSSSSSSSSSSSSSSSSSSSSSSSSSSSSSSSSSSSSSSSSSSSSSSS
PRRRPRPPPPPPPPPPPPPPPPPPPPPPPPPPPPPPPPPPPPPPPPPPPPPPPPPPPPPPPPPPPPPPPPPPPPPPPPPPPPPPPPPPSSSSSSSSSSSSSSSSSSSSSSSSSSSSSSSSSSSSSSSS
PRRRPRRRPRRRPRRRPRRRPRRRPRRRPRRRPRRRPRRRPRRRPRRRPRRRPRRRPRRRPRRRPRRRPRRRPRRRPRRRPRRRPRRRPRRRPRRRPRRRPRPPPPPPPPPPPPPPPPPPPPPSSSSS
PRRRPRRRPRRRPRRRPRRRPRRRPRRRPRRRPRRRPRRRPRRRPRRRPRRRPRRRPRRRPRRRPRRRPRRRPRRRPRRRPRRRPRRRPRRRPRRRPRRRPRRRPRRRPRRRPRRRPPPPPPPPSSSS
PRRRPRRRPRRRPRRRPRRRPRRRPRRRPRRRPRRRPRRRPRRRPRRRPRRRPRRRPRRRPRRRPRRRPRRRPRRRPPPPPPPPPPPPPPPPPPPPPPPPPPPPPPPPPPPPPPPPPPPPSSSSSSSS
PRRRPRRRPRRRPRRRPRRRPRRRPRRRPRRRPRRRPRRRPRRRPRRRPRRRPRRRPPPPPPPPPPPPPPPPPPPPPPPPPPPPPPPPPPPPPPPPPPPPPPPPPPPPPPPSSSSSSSSSSSSSSSSS
PRRRPRRRPRRRPRRRPRRRPRRRPRRRPRRRPRRRPRRRPRRRPRRRPRRRPRRRPRRRPRRRPRRRPRRRPRRRPRRPPPPPPPPPPPPPPPPPPPPPPPPPPPPPSSSSSSSSSSSSSSSSSSSS
PRRRPRRRPRRRPRRRPRRRPRRRPRRRPRRRPRRRPRRRPRRRPRRRPRRRPRRRPRRRPRRRPRRRPRRRPRRRPRRRPRRRPRRRPRRRPRRRPRRRPRRRPRPPPPPSSSSSSSSSSSSSSSSS
PRRRPRRRPRRRPRRRPRRRPRRRPRRRPRRRPRRRPRRRPRRRPRRRPRRRPRRRPRRRPRRRPRRRPRRRPRRRPRRRPRRRPRRRPRRRPRRRPRRRPRRRPRRRPRRRPRRSSSSSSSSSSSSS
PRRRPRRRPRRRPRRRPRRRPRRRPRRRPRRRPRRRPRRRPRRRPRRRPRRRPRRRPRRRPRRRPRRRPRRRPRRRPRRRPRRRPRRRPRRRPRPPPPPPPPPPPPPPPPPPPPPPPPPPPPPPPPPS
PRRRPRRRPRRRPRRRPPPPPPPPPPPPPPPPSSSSSSSSSSSSSSSSSSSSSSSSSSSSSSSSSSSSSSSSSSSSSSSSSSSSSSSSSSSSSSSSSSSSSSSSSSSSSSSSSSSSSSSSSSSSSSSS
PRRRPRRRPRRRPRRRPRRPPPPPPPPPPPPPPPPPPPPPPPPPPPPPPPPPPPPPPPPPPPPPPPPPPPPPPPPPPPPPPPPPPPPPPPPPPPPPPPPPPPPPPPPPPSSSSSSSSSSSSSSSSSSS
PRRRPRRRPRRRPRRRPRRRPRRRPRRRPRRRPRRPPPPPPPPPPPPPPPPPPPPPSSSSSSSSSSSSSSSSSSSSSSSSSSSSSSSSSSSSSSSSSSSSSSSSSSSSSSSSSSSSSSSSSSSSSSSS
PRRRPRRRPRPPPPPPPPPPPPPPPPPPPPPPPPPPPPPPPPPPPPPPPPPPPPPPPPPPPPPPPPPPPPPPPPPPPPPPPPPPPPPPPPPPPPPPPPPPPPPPPPPPPPPPPPPPPPPSSSSSSSSS
PRRRPRRRPRRRPRRRPRRRPRRRPRRRPRRRPRRRPRRRPRRRPRRRPRRRPRRRPRRRPRRRPRRRPRRRPRRPPPPSSSSSSSSSSSSSSSSSSSSSSSSSSSSSSSSSSSSSSSSSSSSSSSSS
PRRRPRRRPRRRPRRRPRRRPRRRPRRRPRPPPPPPPPPPPPPPPPPPPPPPPPPPPPPPPPPPPPPPPPPPPPPPPPPSSSSSSSSSSSSSSSSSSSSSSSSSSSSSSSSSSSSSSSSSSSSSSSSS
PRRRPRRRPRRRPRRRPRRRPRRRPRRRPRRRPRRRPRRRPRRRPRRRPRRRPRRRPRRRPRRRPRRRPRRRPRRRPRRRPRRRPRRRPRRRPRRRPRRRPRRRPRRRPRRRPRRRPRRRPRRRPRSS
PRRRPRRRPRRRPRRRPRRRPRRRPRRRPRRRPRRRPRRRPRRRPRRRPRRRPRRRPRRRPRRRPRRRPRRRPRRRPRRRPRRRPRRRPRRRPPPPPPPPPPPPPPPPPPPPPPPPPPPPPSSSSSSS
PRRRPRRRPRRRPRRRPRRRPRRRPRRRPRRRPRRRPRRRPRRRPRRRPRRRPRRRPRRRPRRRPRPPPPPPPPPPPPPPPPPPPPPPPPPPPPPPPPPPPPPPPPPPPPPPPPPPPPPPSSSSSSSS
PRRRPRRRPRRRPRRRPRRRPRRRPRRRPRRRPPPPPPPPPPPPPPPPPPPPPPPPPPPPPPPPPPPPPPPPPPPPPPPPPPPPPPPPPPPPPPPPPPPPPPPPPPSSSSSSSSSSSSSSSSSSSSSS
PRRRPRRRPRRRPRRRPRRRPRRRPRPPPPPPPPPPPPPPPPPPPPPPPPPPPPPPPPPPPPPPSSSSSSSSSSSSSSSSSSSSSSSSSSSSSSSSSSSSSSSSSSSSSSSSSSSSSSSSSSSSSSSS
PRRRPRRRPRRRPRRRPRRRPRRPPPPPPPPPPPPSSSSSSSSSSSSSSSSSSSSSSSSSSSSSSSSSSSSSSSSSSSSSSSSSSSSSSSSSSSSSSSSSSSSSSSSSSSSSSSSSSSSSSSSSSSSS
PRRRPRRRPRRRPRRRPRRRPRRRPRRRPRRRPRRRPRRRPRRRPRRRPPPPPPPPPPPPPPPPPPPPPPPPPPPPPPPPPPPPPSSSSSSSSSSSSSSSSSSSSSSSSSSSSSSSSSSSSSSSSSSS
PRRRPRRRPRRRPRRRPRRRPRRRPRRRPRRRPRRRPRRRPRRRPRRRPRRRPRRPPPPPPPPPPPPPPPPPPPPPPPPPPPPPPPPPPPPPPPPPPPPPPPPPPPPPPPPSSSSSSSSSSSSSSSSS
PRRRPRRRPRRRPRRRPRRRPRRRPRRRPRRRPRRRPRRRPRRRPRRRPRRRPRRRPRRRPRRRPRRRPRRRPRRRPRRRPRRRPRRRPRRRPRRRPRRRPRRRPRRRPRRRPRPSSSSSSSSSSSSS
PRRRPRRRPRRRPRRRPRRRPRRRPRPPPPPPPPPPPPPPPPPPPPPPPPPPPPPPPPPPPPPPPPPPPPPPPPPPPPPPPPPPPPPPPPPPPPPPPPPPPPPSSSSSSSSSSSSSSSSSSSSSSSSS
PRRRPRRRPRRRPRRRPRRRPRRRPRPPPPPPPPPPPPPPSSSSSSSSSSSSSSSSSSSSSSSSSSSSSSSSSSSSSSSSSSSSSSSSSSSSSSSSSSSSSSSSSSSSSSSSSSSSSSSSSSSSSSSS
PRRRPRRRPRRRPRRRPRRRPRRRPRRRPRRRPRRRPRRRPRRRPRRRPRRRPRRRPRRRPRRRPRRRPRRRPRRRPRRRPRRRPRRRPRRRPRRPPPPPPPPPPPPPPPPPPPPPPPPPSSSSSSSS
PRRRPRRRPRRRPRRRPRRRPRRRPRRRPRRRPRRRPRRRPRRRPRRRPRRRPRRRPRRRPRRRPRRRPRRRPRRRPRRRPRRRPRRRPRRRPRRRPRRRPRPSSSSSSSSSSSSSSSSSSSSSSSSS
PRRRPRRRPRRRPRRRPRRRPRRRPRRRPRRRPRRRPRRRPRRRPRRRPRRRPRRRPRRRPRRRPRRRPRRRPRRRPRRRPRRRPRRRPRRRPRRRPRRRPRRRPRRRPRRRPRRRPRPPPPPPPPSS
PRRRPRRRPRRRPRRRPRRPPPPPPPPPPPPPPPPPPPPPPPPPPPPPPPPPPPPPPPPPPPPPPPPPPPPPPPSSSSSSSSSSSSSSSSSSSSSSSSSSSSSSSSSSSSSSSSSSSSSSSSSSSSSS
PRRRPRRRPRRRPRRRPRRRPRPPPPPPPPPPPPPPPPPPPPPPPPPPPPPPPPPPPPPPPPPPPPPSSSSSSSSSSSSSSSSSSSSSSSSSSSSSSSSSSSSSSSSSSSSSSSSSSSSSSSSSSSSS
PRRRPRRRPPPPPPPPPPPPPPPPPPPPPPPPPPPPPPPPPPPPPPPPPPPPPPPPPPPPPPPPPPPPPPPPPPPPPPPPPPPPPPPPPPPPPPPPSSSSSSSSSSSSSSSSSSSSSSSSSSSSSSSS
PRRRPRRRPRRRPRRRPRRRPRRRPRRRPRRRPRRRPRRRPRRRPRRRPRRRPRRRPRRRPRRRPRRRPRRRPRRRPRRRPRRRPRRRPRRRPRRRPRRRPRRRSSSSSSSSSSSSSSSSSSSSSSSS
PRRRPRRRPRRRPRRRPRRRPRRRPRRRPRRRPRRRPRRRPRRRPRRRPRRRPRRRPRRRPRRRPRRRPRRRPRRRPRRRPRRRPRRRPRRRPRRRPRRRPRRRPRRRPRRRPRPPPPPPPPPSSSSS
PRRRPRRRPRRRPRRRPRRRPRRRPRRRPRRRPRRRPRRRPRRRPRRRPRRRPRRRPRRRPRRRPRRRPRRRPRRRPRRRPRRRPRRRPRRRPRRRPRRRPRRRPRRRPRRPPPPPPPPPPPPSSSSS
PRRRPRRRPRRRPRRRPRRRPRRRPRRPPPPPPPPPPSSSSSSSSSSSSSSSSSSSSSSSSSSSSSSSSSSSSSSSSSSSSSSSSSSSSSSSSSSSSSSSSSSSSSSSSSSSSSSSSSSSSSSSSSSS
PRRRPRRRPRRRPRRRPRRRPRRRPRRRPRRRPRRRPRRRPRRRPRRRPRRRPRRRPRRRPRRRPRRRPRRRPRRRPRRRPRRRPRRRPRRRPRRRPRRRPRRRPRRRPRRRPRRRPRRRPRRPSSSS
PRRRPRRRPRRRPPPPPPPPPPPPPPPPPPPPPPPPPPPPPPPPPPPPPPPPPPPPPPPPPPPPPPPPPPPPSSSSSSSSSSSSSSSSSSSSSSSSSSSSSSSSSSSSSSSSSSSSSSSSSSSSSSSS
PRRRPRRRPRRRPRRRPRRRPRRRPRRRPRRRPRRRPPPPPPPPPPPPPPPPPPPPPPPPPPPPPPPPPPPPPPPPPPPPPPPPPPPPPPPPPPPPPPPPPPPPSSSSSSSSSSSSSSSSSSSSSSSS
PRRRPRRRPRRRPRRRPRRRPRRRPRRRPRRRPRRRPRRRPRRRPRRRPRRRPRRRPRRRPRRRPRRRPRRRPRRRPRRRPRRRPRRRPRRRPRRRPRRRPRRPSSSSSSSSSSSSSSSSSSSSSSSS
PRRRPRRRPRRRPRRRPRRRPRRRPPPPPPPPPPPPPPPPPPPPPPPPPPPPPPPPPPPPPPPPPPPPPPPPPPPPPPPPPPPPPPPPPPPPPPPPPPPPPPPPPPPPPPPPPSSSSSSSSSSSSSSS
PRRRPRRRPRRRPRRRPRRRPRRRPRRRPRRRPRRRPRRRPRRRPRRRPRRRPRRRPRRRPRRRPRRRPRRRPRRRPRRRPRRPPPPPPPPPPSSSSSSSSSSSSSSSSSSSSSSSSSSSSSSSSSSS