PRRRPRRRPRRRPRRRPRRRPRRRPRSSSSSS
PRRRPRRRPRRRPRRRPRRRPRRRPRRRPRPS
PRRRPRRRPRRRPRRRPRRRPRRRPRRSSSSS
PRRRPRRRPRRRPRRRPRRRPRRRPPPPPPPS
PRRRPRRRPRRRPRRRPRPPPPPPPPPPPPSS
PRRRPRRRPRRRPRRRPRRRPRRRPRRRPRPS
PRRRPRRRPRRRPRRPPPPPPPSSSSSSSSSS
PRRPPPPPPPPPPPPPPPPSSSSSSSSSSSSS
PRRPPPPPPPPPPPPPPPSSSSSSSSSSSSSS
PRRRPRRRPPPPPSSSSSSSSSSSSSSSSSSS
PRRRPRRRPRRRPRRRPRRRPRRPPPPSSSSS
PRRRPRRRPRRRPRRRPRPPPPPPPPPSSSSS
PRRPPPPPSSSSSSSSSSSSSSSSSSSSSSSS
PRRRPRRRPRRRPRRRPRRRPRPPPPPSSSSS
PRRRPRRRPRRRPRRRPRRRPRRRPRRSSSSS
PRRRPRRPPPPPPPPPPPSSSSSSSSSSSSSS
PRRRPPPPPPPSSSSSSSSSSSSSSSSSSSSS
PRRRPRRRPRRRPRRRSSSSSSSSSSSSSSSS
PRRRPRRPPPPPPPPPPPPPPPPPPPPPPSSS
PRPPPPPPPPPPPPPPPPPPPPPSSSSSSSSS
PRRRPRRRPRRRPRRRPRRRPRRRPRRRPPSS
PRRRPRRRPRRRPRRRPRRRPRRRPPPSSSSS
PRRRPRRPPSSSSSSSSSSSSSSSSSSSSSSS
PRRRPRRRPRRPPPSSSSSSSSSSSSSSSSSS
PRPPPPPPPPPPPPPPPPPPPPPPPPPPPSSS
PRRRPRRRPRRRPRRRPRRPPPPPPSSSSSSS
PRRRPRRRPRRRPRPPPPSSSSSSSSSSSSSS
PRRRPPPPPPPPPSSSSSSSSSSSSSSSSSSS
PRRRPRRRPRRRPRRRPRRRPRRRPRPSSSSS
PRRRPRRRPRRRPRRPPPPPPPPPSSSSSSSS
PRRRPRRRPRRRPRRRPRPPPPPPPPPPPSSS
PRRRPRRRPPPSSSSSSSSSSSSSSSSSSSSS
PRRRPRRRPRRRPRRRPRRRPRRPPPPPSSSS
PRRRPRPPPPPPPPPPPPPPPPSSSSSSSSSS
PRRRPRRRPRRRPRRRPRRRPRRRPRPPPPPS
PRRRPRRRPRRPPPPPPPPPPPPPPPPSSSSS
PRRRPRRRPRRRPRRRPRRRPRRPPPPPPSSS
PRRRPRRRPRRRPRRRPRRPPSSSSSSSSSSS
PRRRPRRRPRRRPRRRPRRRPPPPPPSSSSSS
PRRRPRRRPRRRPRRRPRRRPRRRPRPPPPSS
PRRRPRRRPRRRPRRPPPPPPPPPSSSSSSSS
PRRRPRRRPRPPPPPSSSSSSSSSSSSSSSSS
PRRPPPPPPPPPPPPPPPPSSSSSSSSSSSSS
PRRRPRRRPRRRPRRRPRRRPPSSSSSSSSSS
PRRRPRRRPRRRPRRRPRRPPPPSSSSSSSSS
PRRRPRRPPPPPPPSSSSSSSSSSSSSSSSSS
PRRRPRRRPRRPSSSSSSSSSSSSSSSSSSSS
PRRRPRRRPRRRPRRRPRRRPPPSSSSSSSSS
PRRRPRRRPRRRPRRRPRRRPPPPPPPPPPSS
PRRRPRRRPRRRPRRRSSSSSSSSSSSSSSSS