PRRRPRRRPPPPPPPPPPPPPPPPPPPPPPPPPPPPPPPPPPPPPPPPPPPPPPPPPPPPPPPPPPPPPPPPPPPPPPPPPPPPPPPPPPPPPSSSSSSSSSSSSSSSSSSSSSSSSSSSSSSSSSSS
PRRRPPPPPPPPPPPPPPPPPPPPPPPPPPPPPPPPPPPPPPPPPPPPPPPSSSSSSSSSSSSSSSSSSSSSSSSSSSSSSSSSSSSSSSSSSSSSSSSSSSSSSSSSSSSSSSSSSSSSSSSSSSSS
PRRRPRRRPRRRPRRRPRRRPRRRPRRRPRRRPRRRPRRRPRRRPRRRPRRRPRRRPRRRPRRRPRRRPRRRPRRRPRRRPRRRPRRRPRRRPRRPPPPPPPPPPPPPPPPPPSSSSSSSSSSSSSSS
PRRRPRRRPRRRPRRRPRRRPRRRPRRRPRRRPRRRPRRRPRRRPRRRPRRRPRRRPRRRPRRRPRRRPRRRPRRRPRRRPRPPPPPPPPPPPPPPPPPPPPPPPPPPPSSSSSSSSSSSSSSSSSSS
PRRRPRRRPRRRPPSSSSSSSSSSSSSSSSSSSSSSSSSSSSSSSSSSSSSSSSSSSSSSSSSSSSSSSSSSSSSSSSSSSSSSSSSSSSSSSSSSSSSSSSSSSSSSSSSSSSSSSSSSSSSSSSSS
PRRRPRRRPRRRPRRRPRRRPRRRPRRRPRRRPRRRPRRRPRRRPRRRPRRRPRRRPRRRPRRRPRRRPRRRPPPPPPPPPPPPPPPPPPPPPPPPPPPPPPSSSSSSSSSSSSSSSSSSSSSSSSSS
PRRRPRRRPRRRPRRRPRRRPRRRPRRRPRRRPRRRPRRRPRRRPRRRPRRRPRRRPRRRPRRRPRRRPRRRPRRRPRRRPRRRPRRRPPPPPPPPPPPPPPPPPPPPPPPPPPSSSSSSSSSSSSSS
PRRRPRRRPRRRPRPSSSSSSSSSSSSSSSSSSSSSSSSSSSSSSSSSSSSSSSSSSSSSSSSSSSSSSSSSSSSSSSSSSSSSSSSSSSSSSSSSSSSSSSSSSSSSSSSSSSSSSSSSSSSSSSSS
PRRRPRRRPRPPPPPPPPPPPPPPPPPPPPPPPPPPPPPPPPPPPPPPPPPPPPPPPPPPPPPPPPPPPPPPPPPPPSSSSSSSSSSSSSSSSSSSSSSSSSSSSSSSSSSSSSSSSSSSSSSSSSSS
PRRRPRRRPRRRPRRRPRRRPRRRPRRRPRRRPRRRPRRRPRRRPRRRPRRPPPPPPPPPPPPPPPPPPPPPPPPPPPPPPPPPPPPPPPPPPPPPPPPPPPPPPPPPPPPPPPPPPPSSSSSSSSSS
PRRRPRRRPRRRPRRRPRRRPRRRPRRRPRRRPRRRPRRRPRRRPRRRPRRRPRRRPRRRPRRRPRRRPRRRPRRRPRRRPRRRPRRRPRRRPRRRPRRRPRRRPRRRPRRRPRRRPRRRPRRPSSSS
PRRRPRRRPRRRPRRRPRRRPRRRPRRRPRRRPRRRPRRRPRRRPRRRPRRRPRRRPRRRPRRRPRRRPRRRPRRRPRRRPRRRPRRRPRRRPRRRPRRRPRRRPRRRPRPPPPPPPPPPPPPPSSSS
PRRRPRRRPRRRPRRRPRRRPRRRPRRRPRRRPRRRPRRRPRRRPRRRPRRRPRRRPRRRPRRRPRRRPRRRPRRRPRRRPRRRPRRRPRRRPRRRPRRRPRRRPRPPPPPPPPPPPPPPPPPSSSSS
PRRRPRRRPPPPPPPPPPPPPPPPPPPPPPPPPPPPPPPPPPPPPPPPPPPPPPPPPPPPPPPPPPPPPPPPPPPPPPPPPPPPPPPPPPPPPPPPPPPPPPPPPPPPPPPPPPPSSSSSSSSSSSSS
PRRRPRRRPRRRPPPPPPPPPPPPPPPPPPPPPPPPPPPPPPPPPPPPPPPPPPPPPPPPPPPPPPPPPPPPPPPPPPPPPPPPPPPPPPPSSSSSSSSSSSSSSSSSSSSSSSSSSSSSSSSSSSSS
PRPPPPPPPPPPPPPPPPPPPPPPPPPPPPPPPPPPPPPPPPPPPPPPPPPPPPPPPPPPPPPPPPPPPPPPPPPPPPPPPPPPPPPPPPPPPPPPPPPPSSSSSSSSSSSSSSSSSSSSSSSSSSSS
PRRRPRRRPRRRPRRRPRRRPRRRPRRRPRRRPRRRPRRRPRRRPRRRPRRRPRRRPRRRPRRRPRRRPRRRPRRRPRRRPRRRPRRPPPPPPPPPPPPPPPPPPPPPPPPPPPPPPPPSSSSSSSSS
PRRRPRRRPRRRPRRRPRRRPRRRPRRRPRRRPRRRPRRRPRRRPRRRPRRRPRRRPRRRPRRRPRRRPRRRPRRRPRRRPRRRPRRRPRRRPRRRPRRRPRRRPRPPPPPPPPPPPPPPPPPPPPSS
PRRRPRRRPRRRPRRRPRRRPRRRPRRRPRRRPRRRPRRRPRRRPRRRPRRRPRRRPRRRPRRRPRRRPRRRPRRRPRRRPRRRPRRRPRRRPRRRPRRRPRRRPRRRPRPPPPSSSSSSSSSSSSSS
PRRRPRRRPRRRPRRRPRRRPRRRPRRRPRRRPRRRPRRRPRRRPRRRPRRRPRRRPRRRPRRRPRPPPPPPPPPPPPPPPPPPPPPPPPPPPPPPPPPPPPSSSSSSSSSSSSSSSSSSSSSSSSSS
PRRRPRRRPRRRPRRRPRRRPRRRPRRRPRRRPRRRPRRRPRRRPRRRPRRRPRRRPRRRPRRRPRRRPRRRPRRRPRRRPRRRPRRPPPPPPPPPPPPPPPPPPPPPPPSSSSSSSSSSSSSSSSSS
PRRRPRRRPRRRPRRRPRRRPRRRPRRRPRRRPRRRPRRRPRRRPRRRPRRRPRRRPRRRPRRRPRRRPRRRPRRRPRRRPRRRPRRRPRRRPRRRPRRRPRRRPRRRPRRRPRRRPPSSSSSSSSSS
PRRRPRRRPRRRPRRRPRRRPRRRPRRRPRRRPRRRPRRRPRRRPRRRPRRRPRRRPRRRPRRRPRRRPRRRPRRRPRRRPRRRPRRRPRRRPRRRPRRRPRRRPRRRPRRRPRRRPRRRPRRRPRPS
PRRRPRRRPRRRPRRRPRRRPRRRPRRRPRRRPRRRPRRRPRRRPRRRPRRRPRRRPRRRPRRRPRRRPRRRPRRRPRRRPRRRPRRRPRRRPRRRPRPPPPPPPPPPPPPPPPPPPPSSSSSSSSSS
PRRRPRRRPRRRPRRRPRRRPRRRPRRRPRRRPRRRPRRRPRRRPRRRPRRRPRRRPRRRPRRRPRRRPRRRPRRRPRRPPPPPPPPPPPPPPPPPPPPPPPPPPPPPPPPPPPSSSSSSSSSSSSSS
PRRRPRRRPRRRPRRRPRRRPRRRPRRRPRRRPRRRPRRRPRRRPPPPPPPPPPPPPPPPPPPPPPPPPPPPPPPPPPPPPPPPPPPPPPPPPPPSSSSSSSSSSSSSSSSSSSSSSSSSSSSSSSSS
PRRRPRRRPRRRPRRRPRRRPRRRPRRRPRRRPRRRPRRRPRRRPRRRPRRRPRRRPRRRPRRRPRRRPRRRPRRRPRRRPRRRPRRRPPPPPPPPPPPPPSSSSSSSSSSSSSSSSSSSSSSSSSSS
PRRRPRRRPRRRPRRRPRRRPRRRPRRRPRRRPRRRPRRRPRRRPRRRPRRRPRRRPRRRPRRRPRRRPRRRPRRRPRRRPRRRPRRRPRRRPRRRPRRRPRRPPPPPPPPPPPPPPPPPPPSSSSSS
PRRRPRRRPRRRPRRRPRRRPRRRPRRRPRRRPRRRPRRRPRRRPRRRPRRRPRRRPRRRPRRRPRRRPRRRPRRRPRRRPRRRPRRRPRRRPRRRPRRRPRRRPRPPPPPPPPPPPPPPSSSSSSSS
PRRRPRRRPRRRPRRRPRRRPRRRPRRPPPPPPPPSSSSSSSSSSSSSSSSSSSSSSSSSSSSSSSSSSSSSSSSSSSSSSSSSSSSSSSSSSSSSSSSSSSSSSSSSSSSSSSSSSSSSSSSSSSSS
PRRRPRRRPRRRPRRRPRRRPRRRPRRRPRRRPRRRPRRRPRRRPRRRPRRRPRRRPRRRPRRRPRRRPRRRPRPPPPPPPPPPPPPPPPPPPSSSSSSSSSSSSSSSSSSSSSSSSSSSSSSSSSSS
PRRRPRRRPRRRPRRRPRRRPRRRPRRRPRRRPRRRPRRRPRRRPRRRPRRRPRRRPRRRPRRRPRRRPRRRPRRRPRRRPRRRPRRRPRRRPRRRPRRRPRRRPRPSSSSSSSSSSSSSSSSSSSSS
PRRRPRRRPRRRPRPPPPPPPPPPPPPPPPPPPPPPPPPPPPPPPPPPPPPPPPPPPPPPPPPPPPPPPPPPPPPPPPPPPPPPPPPPPPPPPPPPPPPPPPPPPSSSSSSSSSSSSSSSSSSSSSSS
PRRRPRRRPRRRPRRRPRRRPRRRPRRRPRRRPRRRPRRRPRRRPRRRPRRRPRRRPRRRPRRRPRRRPRRRPRRRPRRRPRRRPRRRPRRRPRRRPRRRPRRRPRRRPRRRPRRRPPPPSSSSSSSS
PRRRPRRRPPPPPPPPPPPPPPPPPPPPPPPPPPPPPPPPPPPPPPPPPPPPPPPPPPPPPPPPPPPPPPPPPPPPPPPPPPPPPPPPPPPPPPPPPPPPPPPPPPPPPPPPPPPPPPPPPPPPSSSS
PRRRPRRRPRRRPRRRPRRRPRRRPRRRPRRRPRRRPRRRPRRRPRRRPRRRPRRRPRRRPRRRPRRRPRRRPRRRPRRRPRRRPRRRPRRRPRRRPRRRPRRRPRRPPPPPPPPPPPPPSSSSSSSS
PRRRPRRRPRRRPRRRPRRRPRRRPRRRPRRRPRRRPRRRPRRRPRRRPRRRPRRRPRRRPRRRPRRRPRPPPPPPPPPPPPPPPPPPPPPPPPPPPPPPPPPPPPPPPPPPPPPPPPPPPPPPPPSS
PRRRPRRRPRRRPRRRPRRRPRRRPRRRPRRRPRRRPRRRPRRRPRRRPRRRPRRRPRRRPRRRPRRRPRRRPRRRPRRRPPPPPPPPPPPPPPPPPPPPPPPPPPPPPPPPPPPPPPPPPSSSSSSS
PRRRPRRRPRRRPRRRPRRRPRRRPRRRPRRRPRRRPRRRPRRRPRRRPRRRPRRRPRRPPPPPPPPPPPPPPPPPPPPPPPPPPPPPPPPPPPPPPPPPPPPPSSSSSSSSSSSSSSSSSSSSSSSS
PRRRPRRRPRRRPRRRPRRRPRRRPRRRPRRRPRRRPRPPPPPPPPPPPPPPPPPPPPPPPPPPPPPPPPPPPPPPPPPPPPPPPPPPPPPPPPPPPSSSSSSSSSSSSSSSSSSSSSSSSSSSSSSS
PRRRPRRRPRRRPRRRPRRRPRRRPRRRPRRRPRRRPRRRPRRRPRRRPRRRPRRRPRRRPRRRPRRRPRRRPRPPPPPPPPPPPPPPPPPPPPPPPPPPPPPPPPPPPPSSSSSSSSSSSSSSSSSS
PRRPPPPPPPPPPPPPPPPPPPPPPPPPPPPPPPPPPPPPPPPPPPPPPPPPPPPPPPPPPPPPPPPPPPPPPPPPPPPPPPPPPPPPPPPPPPPPPPPPPPPPSSSSSSSSSSSSSSSSSSSSSSSS
PRRRPRRRPRRRPRRRPRRRPRRRPRRRPRRRPRRRPRRPPPPPPPPPPPPPPPPPPPPPPPPPPPPPPPPPPPPPPPPPPPPPPPPPPPPPPPPPPPPPPPPPPPPPPSSSSSSSSSSSSSSSSSSS
PRRRPRRRPRRRPRRRPRRRPRRRPRRRPRRRPRRRPRRRPRRRPRRRPRRRPRPPPPPPPPPPPPPPPPPPPPPPPPPPPPPPPPPPPPPPPPPPPPPPPPPPPPPPPPPPPPPPPPSSSSSSSSSS
PRRRPRRRPRRRPRRRPRRRPRRRPRRRPRRRPRRRPRRRPRRRPRRRPRRRPRRRPRRRPRRRPRRRPRRRPRRRPRRRPRRRPRRPPPPPPPPPSSSSSSSSSSSSSSSSSSSSSSSSSSSSSSSS
PRRRPRRRPRRRPRRRPRRRPRRRPRRRPRRRPRRRPRRRPRRRPRRRPRRRPRRRPRRRPRRRPRRRPRRRPRRPPPPPPPPPPPSSSSSSSSSSSSSSSSSSSSSSSSSSSSSSSSSSSSSSSSSS
PRRRPRRRPRRRPRRRPRRRPRRRPPPPPPPPPPPPPPPPPPPPPPPPPPPPPPPPPPPPPPPPPPPPPPPPPPPPPPPPPPPPPPPPPPPPPPPPPPPPPPPPPPPPPPPPPPPSSSSSSSSSSSSS
PRRRPRRRPRRRPRRRPRRRPRRRPPPPPPPPPPPPPPPPPPPPPPPPPPPPPPPPPPPPPPPPPPPPPPPPPPPPPPPPPPPPPPSSSSSSSSSSSSSSSSSSSSSSSSSSSSSSSSSSSSSSSSSS
PRRRPRRRPRRRPRRRPRRRPRRRPRRRPRRRPRRRPRRRPRRRPRRRPRRRPRRRPRRRPRRRPRPPPPPPPPPPPPPPPPPPPPPPPPPPPPPPPPPPPPPPPPPPPPPPPPPPPPPPPPPPPPSS
PRRRPRRRPRRRPRRRPRRRPRRRPRRRPRRRPRRRPRRRPRRRPRRRPRRRPRRRPRRRPRRRPRRRPRRRPRRRPRRRPRRRPRRRPRRRPRRPPPPPPPPPPPPSSSSSSSSSSSSSSSSSSSSS
PRRRPRRRPRRRPRRRPRRRPRRRPRRRPRRRPRRRPRRRPRRRPRRRPRRRPRRRPRRRPRRPPPPPPPPPPPPPPPPPPPPPPSSSSSSSSSSSSSSSSSSSSSSSSSSSSSSSSSSSSSSSSSSS
PRRRPRRRPRRRPRRRPRRRPRRRPRRRPRRRPRRRPRRRPRRRPRRRPRRRPRRRPRRRPRRRPPPPPPPPPPPPPPPPPPPPPPPPPPPPPPPPPPPPPPPSSSSSSSSSSSSSSSSSSSSSSSSS
PRRRPRRRPRRRPRRRPRRRPRRRPRRRPRRRPRRRPRRRPRRRPRRRPRRRPRRRPRRRPRRRPRRRPRRRPRRRPRRRPRRRPRRRPRRRPRRRPRRRPRRRPRRRPPPPPPPPPPPPPPSSSSSS
PRRRPRRRPRRRPRRRPRRRPRRRPRRRPRRRPRRRPRRRPRRRPRRRPRRRPRRRPRRRPRRRPRRRPRRRPRRRPRRRPRRRPRRRPRRRPRRRPRRRPRPPPPPPPPPPPPPPSSSSSSSSSSSS
PRRRPRRRPRRRPRRRPRRRPRRRPRRRPRRRPPPPPPPPPPPPPPPPPPPPPPPPPPPPPPPPPPPPPPPPPPPPPPPPPPPPPPPPPPPPPPPPPPPPPPPPPPPPSSSSSSSSSSSSSSSSSSSS
PRRRPRRRPRRRPRRRPRRRPPPPPPPPPPPPPPPPPPPPPPPPPPPPPPPPPPPPPPPPPPPPPPPPPPPPPPPPPPPPPPPPPPPPPPPPPPPPPPPPPPPPPSSSSSSSSSSSSSSSSSSSSSSS
PRRRPRRRPRRRPRRRPPPPPPPPPPPPPPPPPPPPPPPPPPPPPPPPPSSSSSSSSSSSSSSSSSSSSSSSSSSSSSSSSSSSSSSSSSSSSSSSSSSSSSSSSSSSSSSSSSSSSSSSSSSSSSSS
PRRRPRRRPRRRPRRRPRRRPRPPPPPSSSSSSSSSSSSSSSSSSSSSSSSSSSSSSSSSSSSSSSSSSSSSSSSSSSSSSSSSSSSSSSSSSSSSSSSSSSSSSSSSSSSSSSSSSSSSSSSSSSSS
PRRRPRRRPRRRPRRRPRRRPRRRPRRRPRRRPRRRPRRRPRRRPRRRPRRRPRRRPRRRPRRPPPPPPPPPPPPPPPPPPPPPPPPPPPSSSSSSSSSSSSSSSSSSSSSSSSSSSSSSSSSSSSSS
PRRRPRRRPRRRPRRRPRRRPRRRPRRRPRRRPRRRPRRRPRRRPRRRPRRRPRRRPRRRPRRRPRRRPRRRPRRRPRRRPRRRPRRPPPPPPPPPPPPSSSSSSSSSSSSSSSSSSSSSSSSSSSSS
PRRPPPPPPPPPPPPPPPPPPPPPPPPPPPPPPPPPPPPPPPPPPPPPPPPPPPPPPPPPPPPPPPPPPPPPPPPPPPPPSSSSSSSSSSSSSSSSSSSSSSSSSSSSSSSSSSSSSSSSSSSSSSSS
PRRRPRRRPRRRPRRRPRRRPRRRPRRRPRRRPRRRPRRRPRRRPRRRPRRRPRRRPRRRPRRRPRRRPRRRPRRRPRRRPRRRPRRRPRRRPRRRPRRRPRRPPSSSSSSSSSSSSSSSSSSSSSSS
PRRRPRRRPRRRPRRRPRRRPRRRPRRRPRRRPRRRPRRRPRRRPRPPPPPPPPPPPPPPPPPPPPPPPPPPPPPPPPPPPPPPPPPPSSSSSSSSSSSSSSSSSSSSSSSSSSSSSSSSSSSSSSSS
PRRRPRRRPRRRPRRRPRRRPRRRPRRRPRRRPRRRPRRRPRRRPRRRPRRRPRRRPRRRPRRRPRRRPRRRPRRRPRRRPRRRPRRRPRRRPRPPPPPPPPPSSSSSSSSSSSSSSSSSSSSSSSSS
PRRRPRRRPRRPPPPPPPPPPPPPPPPPPPPPPPPPPPPPPPPPPPPPPPPPPPPPPPPPPPSSSSSSSSSSSSSSSSSSSSSSSSSSSSSSSSSSSSSSSSSSSSSSSSSSSSSSSSSSSSSSSSSS
PRRRPRRRPRRRPRRRPRRRPRRRPRRRPRRRPRRRPRRRPRRRPRRRPRRRPRRRPRRRPRPPPPPPPPPPPPPPPPPPPPPPPPPSSSSSSSSSSSSSSSSSSSSSSSSSSSSSSSSSSSSSSSSS
PRRRPRRRPRRRPRPPPPPPPPPPPPPPPPPPPPPPPPPPPPPPPPPPPPPPPPPPPPPPPPPPPPPPPPPPPPPPPPPPPPPPPPPPSSSSSSSSSSSSSSSSSSSSSSSSSSSSSSSSSSSSSSSS
PRRRPRRRPRRRPRRRPRRRPRRRPRRRPRRRPRRPPPPPPPPPPPPPPPPPPPPPPPPPPPPPPPPSSSSSSSSSSSSSSSSSSSSSSSSSSSSSSSSSSSSSSSSSSSSSSSSSSSSSSSSSSSSS
PRRRPRRRPRRRPRRRPRRRPRRRPRRRPRRRPRRRPRRRPRRRPRRRPRRRPRRRPRRRPRRRPRRRPRRRPRRRPRRRPRRRPRRRPRRRPRRRPRRRPRRRPRRRPRRRPRRRPRRRPRRRPPSS
PRRRPRRRPRRRPRRRPRRRPRRRPRRRPRRRPRRRPRRRPRRRPRPPPPPPPPPPPPPPPPPPPPPPPPPPPPPPPPPPPPPPPPPPPPPPPPPPPPPPPSSSSSSSSSSSSSSSSSSSSSSSSSSS
PRRRPRRRPRRRPRRRPRRRPRRRPRRRPRRRPRRRPRRRPRPPPPPPPPPPPPPPPPPPPPPPPPPPPPPPPPPPPPPPPPPPPPPPPPPPPPPPPPPPPPPPPPPPPPPPPPPPPPPPPPPPSSSS
PRRRPRRRPRRRPRRRPRRRPRRRPRRRPRRRPRRRPRRRPRRRPRRRPRRRPRRRPRRRPRRRPRRRPRRRPRRRPRRRPRRRPRRRPRRRPRRRPRRRPRRRPRRRPRRRPRRRPRPPSSSSSSSS
PRRRPRRRPRRRPRRRPRRRPRRRPRRRPRRRPRRRPPPPPPPPPPPPPPPPPPPPPPPPPPPPPPPPPPPPPPPPPPPPPPPPPSSSSSSSSSSSSSSSSSSSSSSSSSSSSSSSSSSSSSSSSSSS
PRRRPRRRPRRRPRRRPRRRPRRRPRRRPRRRPRRRPRRRPRRRPRRRPRRPPPPPPPPPPPPPPPPPPPPPPPPPPPPPPPPPPPPPPPPPPPPPPPPPPPPPPPPPPPPPPPPPPPSSSSSSSSSS
PRRRPRRRPRRRPRRRPRRRPRRRPPPPPPPPPPPPPPPPPPPPPPPPPPPPPPPPPPPPPPPPPPPPPPPPPPPPPPPPPPPPPPPPSSSSSSSSSSSSSSSSSSSSSSSSSSSSSSSSSSSSSSSS
PRRRPRRRPRRRPRRRPRRRPRRRPRRRPRRRPRRRPPPPPPPPPPPPPPSSSSSSSSSSSSSSSSSSSSSSSSSSSSSSSSSSSSSSSSSSSSSSSSSSSSSSSSSSSSSSSSSSSSSSSSSSSSSS
PRRRPRRRPRRRPRRRPRRRPRRRPRRRPRRRPRRRPRRRPRRRPRRRPRRRPRRRPRRRPRRRPRRRPRRRPRRRPRRRPRRRPRRRPRRRPRRRPRRRPRRRPRRRPPPPPPPPPPPPSSSSSSSS
PRRRPRRRPRRRPRRRPRRRPRRRPRRRPRRRPRRRPRRRPRRRPRRRPRRRPRRRPRRRPRRRPRRRPRRRPRRRPRRRPRRRPRRRPRRRPRRPPPPPPPPPPPPPPPPPPPPPPPPSSSSSSSSS
PRRRPRRRPRRRPRRRPRRRPRRRPRRRPRRRPRRRPRRRPRRRPRRRPRRRPRRRPRRRPRRRPRRRPRRRPRRRPRRRPPPPPPSSSSSSSSSSSSSSSSSSSSSSSSSSSSSSSSSSSSSSSSSS
PRRRPRRRPRRRPRRRPRRRPRRRPRRRPRRRPRRRPRRRPRRRPRRRPRRRPRRRPRRRPRRRPRRRPRRRPRRSSSSSSSSSSSSSSSSSSSSSSSSSSSSSSSSSSSSSSSSSSSSSSSSSSSSS
PRRRPRRRPRRRPRRRPRRRPRRRPRRRPRRRPPPPPPPPPPPPPPPPPPPPPPPPPPPPPPPPPPPPPPPPPPPPPPPPPPPPPPPPPPPPPPPPPPPPPPPPPPPPPPPPPPPPPSSSSSSSSSSS
PRRRPRRRPRRRPRRRPRRRPRRRPRRRPRRRPRRRPRRRPRRRPRRRPRRRPRRRPRRRPRRRPRRPPPPPPPPPPPPPPPPPPPPPPPPPPPPPPPPPPPPPPPPSSSSSSSSSSSSSSSSSSSSS
PRRRPRRRPRRRPRRRPRRRPRRRPRRRPRRRPRRRPRRRPRRRPRRRPRRRPRRRPRRRPRRRPRRRPRPPPPPPPPPPPPPPPPPPPPPPPPPSSSSSSSSSSSSSSSSSSSSSSSSSSSSSSSSS
PRRRPRRRPRRRPRRRPRRRPRRRPRRRPRRRPRRRPRRRPRRRPRRRPRRRPRRRPRRRPRRRPRRRPRRRPRRRPPSSSSSSSSSSSSSSSSSSSSSSSSSSSSSSSSSSSSSSSSSSSSSSSSSS
PRRRPRRRPRRRPRRRPRRRPRRRPRRRPRRRPRRRPRRRPRRRPRRRPRRRPRRRPRRRPRRRPRRRPRRRPRRRPRRRPRRRPRRRPRRRPRRRPRRRPRRRPRRRPRRRPRRRPRRRPRRRPPPS
PRRRPRRRPRRRPRRRPRRRPRRRPRRRPRRRPRRRPRRRPRRRPRRRPRRRPRRRPRRRPRRRPPPPPPPPSSSSSSSSSSSSSSSSSSSSSSSSSSSSSSSSSSSSSSSSSSSSSSSSSSSSSSSS
PRRRPRRRPRRRPRRRPRRRPRRRPRRRPRRRPRRRPRRRPRRRPRRRPRRRPRRRPRRRPRRRPRRRPRRRPRRRPRRPPPPPPPPPPPPPPPPPPPPPPPSSSSSSSSSSSSSSSSSSSSSSSSSS
PRRRPRRRPRRRPRRRPRRRPRRRPRRRPRRRPRRRPRRRPRRRPRRRPRRRPRRRPPPPPPPPPPPPPPPPPPPPPPPPPPPPPPPPPPPPPPPPPPPPPPPPPPPPPPPPPPPPPPPPPPPPPPSS
PRRRPRRRPRRRPRRRPRRRPRRRPRRRPRRRPRRRPRRRPRRRPRRRPRRRPRRRPRPPPPPPPPPPPPPPPSSSSSSSSSSSSSSSSSSSSSSSSSSSSSSSSSSSSSSSSSSSSSSSSSSSSSSS
PRRRPRRRPRRRPRRRPRRRPRRRPPPPPPPPPPPPPPPPPPPPPPPPPPPPPPPPPPPPPPPPPPPPPPPPPPPPPPPPPPPPPPPPPPPPPPPPPPPPPPPPPPPPPPPPPPPSSSSSSSSSSSSS
PRRRPRRRPRRRPRRRPRRRPRRRPRRRPRRRPRRRPRRRPRPPPPPPPPPPPPSSSSSSSSSSSSSSSSSSSSSSSSSSSSSSSSSSSSSSSSSSSSSSSSSSSSSSSSSSSSSSSSSSSSSSSSSS
PRRRPRRRPRRRPRRRPRRRPRRRPRRRPRRRPRRRPRRRPRRRPRRRPRRRPRRRPRRRPRRRPRRRPRRRPRRRPRRRPRRRPRRRPRPPPPPPPPSSSSSSSSSSSSSSSSSSSSSSSSSSSSSS
PRRRPRRRPRRRPRRRPRPPPPPPPPPPPPPPPPPPPPPPPPPPPPPPPPPPPPPPPPPPPPPPPPPPPPPPPPPPPPPPPSSSSSSSSSSSSSSSSSSSSSSSSSSSSSSSSSSSSSSSSSSSSSSS
PRRRPRRRPRRRPRRRPRRRPRRRPPPPPPPPPPPPPPPPPPPPPPPPPPPPPPPPPPPPPPPPPPPPPPPPPPPPPPPPPPPPPPPPPPPPPPPPPPPPPPPPPPPPPPPPPPPSSSSSSSSSSSSS
PRRRPRRRPRRRPRRRPRRRPRRRPRRRPRRRPRRRPRRRPRRRPRRRPRRRPRRRPRRRPRRRPRRRPRRRPRRRPRRRPRRRPRRPPPPPPSSSSSSSSSSSSSSSSSSSSSSSSSSSSSSSSSSS
PRRRPRRRPRRRPRRRPRRRPRRRPRRRPRRPPPPPPPPPPPPPPPPPPPPPPPPPPPPPPPPPPPPPPPPPPPPPPPPPPPPPPPPPPPPPPPPPPPPPPPPPPPPPPPPSSSSSSSSSSSSSSSSS
PRRRPRRRPRRRPRRRPRRRPRRRPRRRPRRRPRRRPRRRPRRRPRRRPRRRPRRRPRRRPRRRPRRRPRRRPRRRPRRPPPPPPPPPPPPPPPPPPPPPPPPPPPPPPPPPPPPPPPPPPPPPPPSS
PRRRPRRRPRRRPRRRPRRRPRRRPRRRPRRRPRRRPRRRPRRRPRRRPRRRPRRRPRRRPRRRPRRRPRRRPRRRPRRRPRRRPRRRPRRRPRRRPRRRPRRRPRRRPRRRPRSSSSSSSSSSSSSS
PRRRPRRRPRRRPRRRPRRRPRRRPRRRPRRRPRRRPRRRPRRRPRRRPRRRPRRRPRRRPRRRPRRRPRRRPRRRPRRRPRRRPRRRPRRRPRRRPRRRPRRRPRRPPPPPPPPPPPPPPSSSSSSS
PRRRPRRRPRRRPRRRPRRRPRRRPRRRPRRRPRRRPRRRPRRRPRRRPRRRPRRRPRRRPRRRPRRRPRRRPRRRPRRRPRRRPRRRPRRRPRRRPRRRPRPPPPPPPPPPPSSSSSSSSSSSSSSS