PRRRPRRRPRRPPSSSSSSSSSSSSSSSSSSS
PRRRPRRRPRRRPRRRPRRRPRRRPRRRPSSS
PRRRPRRRPRRRPRRRPRRRPPPPPPPPPPPS
PRRRPRRRPRRRPRRRPRPPPSSSSSSSSSSS
PRRRPRRRPRRPPPPPPPPPPPPPPPPPPSSS
PRRPPPPPPPPSSSSSSSSSSSSSSSSSSSSS
PRRRPRRRPRRRPRRRPRRRPRRRPRRRPSSS
PRRRPRRRPRRRPRRRPRRRPRRRPSSSSSSS
PRRRPRRRPPPPPPPPPPSSSSSSSSSSSSSS
PRRRPRRRPRRRPRRRPRRRPPPSSSSSSSSS
PRRRPPPPPPPPPPPPPPPPPPPPPPPPPPSS
PRRRPRRRPRRRPRRRPRRRPRRRPRRRPSSS
PRRRPRRRPRRPSSSSSSSSSSSSSSSSSSSS
PRRRPRRRPRRRPRRRPRPSSSSSSSSSSSSS
PRRRPRRRPRRRPRRRPRRRPRRRPRRPPSSS
PRRRPRRRPRRRPRRRPRRRPPPPPPPPPPSS
PRRRPRRRPRRRPRRSSSSSSSSSSSSSSSSS
PRRRPPPPPPPPPPPPPPPPPPPPPPSSSSSS
PRRRPRRRPRRRPRRRPRRRPPPPPPPPPPPS
PRRRPRRRPRRRPRRRPRRRPRRRPRRRPRPS
PRRRPRRRPPPPPSSSSSSSSSSSSSSSSSSS
PRRRPRRPPPPPPPPPPPPPPPPPSSSSSSSS
PRPPPPPPPPSSSSSSSSSSSSSSSSSSSSSS
PRRRPRRRPRRRPRRRPRRRPRRRPPPPSSSS
PRRRPRRRPRRRPRRRPRRRPPSSSSSSSSSS
PRRRPRRPPPPSSSSSSSSSSSSSSSSSSSSS
PRRRPRRRPRRRPRRRPRRPPPSSSSSSSSSS
PRRRPRRPPPPPPPPPPSSSSSSSSSSSSSSS
PRRRPRRRPRRRPRRRPRPPPPSSSSSSSSSS
PRRRPRRRPRRRPRRRPRRRPRRRPRRPPPSS
PRRRPRRRPPPPPPPSSSSSSSSSSSSSSSSS
PRRRPRPPPPPPPPPPPPPPPPPSSSSSSSSS
PRRRPPPPPPSSSSSSSSSSSSSSSSSSSSSS
PRRRPRRRPRRRPRRRPRRRPRRPPPPPPSSS
PRRRPRRRPRPPPPPSSSSSSSSSSSSSSSSS
PRRRPPPPPPPPPPPPPPPPPPPPPPPPPSSS
PRRRPRRPPPPPPPPPPPPPPPPPSSSSSSSS
PRRRPRRRPRRPPPPPPPPPPPPPPPPPPPPS
PRRRPRRRPRRRPRRRPRRRPRPPPSSSSSSS
PRRRPPPPPPPPPPPPPPPPPPPPPPPPSSSS
PRRRPRRRPRRRPRRRPRPPPPSSSSSSSSSS
PRRRPRRRPRRRPRRRPRRRPRRRPRPPPSSS
PRRRPRRRPRRRPRRPPPPPPPPPPSSSSSSS
PRRPPPPPPPPPPPPPPPPPSSSSSSSSSSSS
PRPPPPPPPSSSSSSSSSSSSSSSSSSSSSSS
PRRRPRRRPRRRPRRRPPPPPPPSSSSSSSSS
PRPPPPPPPPPPPPPPPPPPPPPPPSSSSSSS
PRRRPRRRPPPPPPPPPPPPPPPPPPPPSSSS
PRRRPRRRPRRRPRRRPRRRPRRRPRPPSSSS
PRRPPPPPPPPPPPPPPPPPPPPPPPSSSSSS