100 128
RSRRRRRSRPPRPSSPSPRPRSSPSPPPSSSSRSRRSSSPPPSPSPSPPPSPRPPPSPPRRRSSRPSSSSSSSSPPSRPRRSPSSSRRSRSSPRRSSSSPSSRPPRSRSPPSSRPRPSPPRSRPPPPS
SSPSRSSRPRSRPPRSSRSPSSRRRSSSSRPSSRRPRSRSPPRSRRSPPRPPRRRSRPSPSRPSPPRSRRRPPSSPRPSSSPSRPSSSRSPSSPSRPRPRSSPPPRPPPRSPPPRRSRPPPRSPSSSS
RRSPSPSRRRPRRPSSSRRRRRRSSSSRRSPSSRRRRPPSRSRPSPSSSPSPRPRSPRSPSPRSPRPSRSRSRPSSPRPPRSPPPSRRPRRPRSPSSPSPPSRSSRSSRRRRRPPPSPSRSPSSRSRP
SRSSPPSRPPPRPRSPRRPPRSPPSRPPSRPRPRRPRPPRSSSSSRSSRRRPPRSRSRPRPSSPSPPSRSRPPRPSRRSRPSSSRRRRRSRRPRSPRSSRRRSPSRSPPPPRPRPPPSSSPRPRSPPP
RSPPSRRSRSPPSPSPPSSSPRRPPSSPSSPSPPSSSSRSRSPSPRPRPPPSSSSRSRSPPRRSRPRSRSPSPRRSRRSRPSRRSSSSRRSRSPRRRSPPSSPSSSRRSPSSPRSSSPSPRRRSSPSP
SPPRPRSPRSSRPSRSSSSRRRRRRPPRRPSSRSSPSPSRRSPPRRSPPRRRRRSSRRRRSRRPPPRPRSPPRSSPSPSPRRSPRPSSSRSRPSRPSSSSPRPRRSRPPRRSRSPRRPSSPRRPPRRP
SRSPSRPRSPRPRRRSSRPRPPSRPPPSRRPRPSPSPPRPPRPSSPPPPPSSPRSRSRPSSSSPPSPRPRRSPRSSPPPRPRSPSPRSSRPPRSPRPPSPRSPPSPSRSPSRPSPRRSSPRSSPSPPS
PSPPSRRPRPSPRRSRSRRRPRSSRRPPPPSRRPSSRPRPRRPSPRSRSRSRSRSSPPSPPSPRPPPRPSRSSRRSSRPPRSPPSSSRSPSRSRRRRPSRPSSSPPRSRSPRRRSPRPSPSRRSPPSS
RSRSRPSSPSSPSRSSSRSSPPSRPPRRSPPSSRSRRSRRPSPSPPRPSSRRSPPPSRPPRPPPRSSRSPRPRSRSPSRSRRSPPPRRRRRRRRRRSSSRRPPPPSPRPPPRSPSSSPSRPRPRSRSS
SRPSRSRSPSSRPPSRPRRRRSPRPSRRRRRPRSRPSPRSPPRPPRPRPPSRRSRPRPPSPPSSPPSRRRRRRSRRSRRRSRRPSRSSPSPRPSSRSRSSSPRPRRSRRSPPRSPRRSPSPPSSRRRP
SSSRSRRPRSSPPRSRRRPSPSPSSPPRSPRRSPRPRRSPSPSPRPRRSSSPPPPSPPPRPPSPSRSSSRSPRSRPSSPSSSSPPRSSSPPRRSPSRSSRPSSPPRSPPPRRRSRRPSPSSPRRSSRS
RRRRRRPSRSRSSSRPRSRPRSRRSPRPPPPPPSPRPPRSRRPPRSSSRRPPPSSRSPPPPSPRSPPPPPRRSPRPPPRSSPPSRPRSRRSSPPRSSSRPRPPPPRPPSPPSPPSPRRSRRPPRPRPP
SSSPPRSPRSSSPPRSPRRRPPRRPPPRSRPRSPPSSPRSPRSSPRRPRSRRRPPRSSPSPSSSPPPRRPPSPPRPRRSPRSPPPSSPRSSSRPPPRRSPPSSSSRRRRPPPSPSRSSPSRSRSSPSP
SPPSRRSSRRRRRPRSSRSRRPSRSPPSSRSRRPPRRPPPRRSPSSRRRPRSRRPSRRRSSRRPPSSPPSRPPPPPRRPPRRRRRPSSRRSRRSRRPRPPSRPPPPPPPSSPSPRPSRPRPRRPRSRP
SRPRRPRPRRSPSRRRPSSPSRPRSRSSRPSRSPSSRPPPRPPSSPPPPRRPSRRRRRSRPSRSPPRSSRSSRSSPRRPRSPPSRRPRPRRSPRPPPPSSRPSSPSSRPPPRPSSPSPSSPPRRSPSS
SPSSPPSRRSSPPPPPRPSSSPSPRSSRSRRPPPPRRSSRPRRSPRPSRRSRPPSPPPPSPRRPSSSPPSPSSRSPPSPSRSPRPPPRSSRSPPPRSPSPSPRSRRSSRPRPRRSSSPSSPPRPRRPS
RRPPRSSPPRPPPSRSPRSSSRPPRPRRSPPRSPSPRPSPPPRSSPRSSPPSRPPRSPSSSPSRRSRPSSRRSRSSRRPSRPSSPPSSPPSRSPSSPPPPSRSSRRPRRRRPSSPPSSSSPSSRSPRP
PSPSSRPSRPSRSPPSPPRPSPPRSSSSPPPRSSRSSPSRPRRRRRSPSSPSSSRPSPSSPRSRPPSPRRPSSSSPSPRPSPPRPRRSSPRPSPRPPSRSSPRRPRRPPSRPPRPPSRPPSPRRSPPS
PPSSRPSRSSRPPPSPRSRRPPPSRSRSPSSPSPPPSSPSPSSRRPRRPSSRSSRRRSSRPSPSSRSSSPRPSRSPPSRSRPPRSPRPSSRSPSPSSRPSPRRSSSSPPRRPRRPRPRPPPSSRSPPS
SPPRPSSPPPSRSSRSRSRRPSSSSPSRSRSSRPPPSPRPPPSRSSSRRRPSPSSRSRRRPRPSRPPSSSPRSPPPRRSRSSRRSSRPRRRPSRSRRRSPRPRSSSPSRSPRPSPSPRRRRRSRPRRP
PRPSPSSRRRRSPRSSSPRRRPSSPSPRPPRPRRRPPPRPRSSRRRPSPPPPRRRSPPSSSPSSPRSRPSPPPRSSRSSPSRPSPSRPRRPPPRPPRSPSPPPRSPRRSPRRRPPSRSPRRPRPSRPP
PSRRPPRSSRSSRSSSRRRRRSSSSPRRRSRPRRPSPSRPPRPSRRSPSRSPRSSPPPRSSRRPPRSRSRRPRSPPRRPSPSSSRPRSPSRPRSPPPSRPRSSPRPSSSPPSSRPRPSRPSRPSPSPP
PSSSPRRSPSRSRSPRSPSRPPPPPPPSSRSSPRRPSPPRRRPPPRRRRRRSPSRSRRPPPSPSRSSRSPRSSRPRPSPRPRSPPPSRRSPPRRSPPPRPRPPPSRSSRRSRRSRPSSSPRRRPRSSP
RPPSPPPPPRPRPRSPSPSPRPSSPRRPRSSRSSRRRPPPSSSSSPRRSRRSPSRRPRPPRPRSSRPSPSSSPRPRSSRPPSPPRSRPRPPSRSRRRSRRPPPRRSSRPSSRPSRPPSRSRRPRSPPR
SSRRSSRPRSRSSPPRPPSPSSRPSSSSSRSSSSPSRSPRSSPPSRRRRPSPPPRRRSPPSPSRPSRPRPSPRSRPSRRPPSRSSRRRPPRSRPSSSRRPRRSRPRPRPRRSRSPRRPPRRRSPPRSS
SPPRSPRSPSSSSRPPSPSPSRRPSSSPRRRRRPRRSSSPSRRRPSPSSPRPSPSSSSPRRSPPPPSPRPSRSPRSRSPRPSSRRSPPRRRSPRSRSPRPPSRPPSPRPSRRRSRPRSSSPRRRSSRP
SRRPPRSSSSPSRRPSPRRRRSRPSPPSRRRRRRRRPSPPRRPPSSRRPSSPSRSRSSRSSSRPPRPRSPSSSRRPPRSPSRSRRRPPPRPSSSSRRPSPRPSPSRPPRPRRPRPSSSSRPPPRSPRP
RSPPSPSRSPPPSSPPPSSPPRPSPRPRPPRRPPRSPPPSPPPRPRRRSPRRRRSPSPSPSPPSRRSSRSSRSRRPRPSSSPPRRPSPRPSPRRRSRSSRRSRRRSRRSSRPRSRSRPSPRRSSRPRP
RSSSRSSRRPRPSPSSSSPRRSRPSRRSSRPSRRSSRPRSRSSRPRRSPPRSSSPRRRRPRPRPSPSPRSSSPRRSPSPPSPSSRPRSRPPPRSRSRPPPRPSPRSSPSRPSRSPSPSRRPPPSPPRR
RPRRSPSSRPRPPPPSSPSSPSPRRPPPSRRSRSRSSRSPPSPRPPPPRPRRPPPRSPSSSRRPSRRSPPSSPRPSSPSRSRPPPRRSPSRPSRSRPSSPPSSRPRSRPRRPSRSSRSRRSRRSRPPP
SRRSPSSSSSPPPRSRRRRPPSRRSSRPPRRPPRPRRSRPSSRRSRPRRRPRPPSRPPSRRPPRSRRRRPSSSPSPRSSRSPSPPRPRSSSPRPSSPSPPSPRRSRPRRSRPSPSPSSSPSSSRPPPR
RPRRSRPPSPPRPSPRSPSPPSPSPRPPRRSRRPSSRSRPSRPSPPPPSSRSSPRSPSPRPSPRSRSPPPSRPRSPPRSPRPPRSPPRSPRSPPPPPPSRSRRSPRSRPSSSRRRPRSSRSSSPRSSR
PPRSPPSRSPSSPPRRRSRSSRSPPSSSRRRRSPRRSRSSSRSSRSSPPRSRRRPPRSSSPPRSPSPSPRPSPRRPSSRSSRRSRPRRSSPPPSSSRSRPPRRRRRPPRRRSRRSSRSSSSSSRPRRS
PRSPPPSPRRSPPPSRPRPPSPPSSSPRSSSPSPRPRPPPSSPSRSRSPPRSRSPPPRRPSPSPSPRSPRSPPSRPRPRPPPPPSRRPSPPRSSSRPRRPPPSSPPPPRSPSPPPSPPSPPSSPSSSP
PRSPSRPPRRSSPRRPPSRSSSPPRPRRRSSRPSPSSSRSRRRRRSRPPSSRRPRPSRSRSRSPSSPPSSRPPPSRPPPRSPSRSRPSRRSSSRSPSPPSPSPSPRPRPRPSSPPPRRRSRRSRSPPP
SPRPPRPPPPRSPSSSPSSPRRSSRPRSRRPPPPPPSPPSRRSRPRSSSRPPRPRSPPPPRSSSRRRRSSSRSSPSSRSSRSRPSSPRPPRPSSSSRPPSSPPSRSRPSSPPSRRRPPPRPRSSRRPR
RSPRPRRSPRPSPSRPRRRRSSPRRSRPPRSSRSRPSPSSRRSRPPPPRSSPRRSRPRPSSSSSRRRRRRSSPRPPPSRPRPPPSRPRSSSPPSSRRPRSPRRRSSRSRRRSSPSSSRSSSRSRSRPR
RRPPRPPSPSRRSPRRSPRRSPPPPSPSPPPRRRPPSPPPRSRSRPSSPRPSRRSSRRRRSSPSRPRRPRRPRRRRPPSSPSPRRPPRSPRSPSSSSRPSRRPSSSSRRSPRRPRSSRPSPPPRSSRR
PSPPPSRRRPRSRPSPSPSRRPRPSSPRSSPRSPPRRSSSPRSPPSSRRRSSPSPRRSPSSSPSSSSRRPSRRRSSPPRRPRRSPPRRSRRRRPPRPSSPPSSRSRSPPSRRPSRPSSRRPSSPSSRS
RSPRRRPSRRPRRSPSRPRPPPSRRSSRRSRPRPRRSRRSSRSSSRRSSPPRRSPPRSPPPPRRSRSSRSSPPRSRSPSSRSSRSSRRPSPRPSPSRSSPRSSPRPPPSPPPRSRRSSSPPSRPPPPP
RSPSSRRSPPRRPPPSPSPPPSPSPSRPSRRRSSPSSRPPPPPSSSPPPRRRSSPSSRSPPSPSPSSRRSPPSPPRPRSRPRRPRPPRSPPPPSSSRRSRPRRPPSRPSRRPRRPRRSPSPRRSRSRR
RSSRSSPRRRPRRRRPPPPSRRPPRPSRSPPPSPSSRSSPPRRPRPRRRRSRPPRSRPSSSSRSPRSPPSRRPSPRPSRRPPPPRRPRRRRPPSPRSRPPPSRSPSRSPPSPSPPSPPRPPPPRRPPR
RSRRPPRRRRSRRPPRPRRSRSRRPSPRRSSRSRRRSPPRRPRPSPRSRPPRPSRRRRSSPPSRSPPRRSSRSPPSPSSRSSSRPPRRSPPPRPSPPRSSSSRRRSRPSPRPPPRSRRSSRSSRRSSP
SSSRRPRPSRSSPRRPPSSRPPSRSRSRRSRRSSRRRPPSRSRPSSSSRSPRPRRSRSSPPPSPPSSSSRRRPRSRRPRRPPRPSRPPPSSPSSRRRRRPPRPRRSSSRSPRSSPSPPRRSSPRRPPP
PSRPSRSRRRRSPRPPSPSRRRPRRRSSPPSPSPSSSPPPPPPSPRSPSSSRRRSSPPPRRPSPRSRRPPSPSRPSPPPRPRPPSSSPRPRRRSRSSPRPPRRPRSSPSPPRRSPPSSSRSPPRSPPP
SRSSPSPRSSRPSPRRRSPPPPSPSPSSSSPPRPRSSSPPRRRRSSPSRPPRRPPSRSRRSRSRSPPRSSSPSSPSPPRRPRRPRPPRRRSPRPRSRRRSRPSRSRRPPSRRRPSSPSPPPSSPRSPS
PRSPRRPPSPSPPSSSPSRRSRPPRRSPSRRRRPSPSRPSPRPRRSSRSRRPPPRPPSRPPSSRSRSSPRSPRPSRRRPSPPPPPRPRSRRPPSPRRRPPSPRSRSPRPSSSPRSRSPPRRRSPPRRR
RRSPSSRRRRPRPPPPSPPSRRRSPRRRPSSSPSRSRSRSRRSRSSPSRSSRPRPRSPSPSRPSRRPRRPPSSRPSPRSRPPPRRRPSRPPPRSSRRRPSSSPSSSSSPRSRSPRSPSSSPSSRRPPP
PSRSSRRPRRPPRPPSSPRRPSSRRPPRPSPPPRPSSPPPSRPRRPRPPRPRSSRRPSSSPPPPPSRSSSSPPRRSSRPRPSSRPSRSSRRSSSRSPRSRRPSRPRSSRPSSPRRSSRRPSRSSSPRS
SPRPPSRSPSPSPSRRSRRRRRSPPSSPRPPRPSPPPSSSSRRPSPRRRRSRPSSSRRPPRRPPSPRPSSRPSPPPRRSSRRRPSRSRRPSRPPPSSPRPSRRPPSSPRPPSRPRSRPPRPPRRPPPS
PSPPSSRPRPSSPPPPRRSRRPSSRPSSSPRSPSSPRRRSPSSRSSPSPRSRPPRSRSSSSSSPRPRRSRRPSRPRRSRSSRPRSPPPRPPRPPRSPSSRRSPSPRRPSPSPSRRPRSRSRRRPSPPR
RSRSSRSRSRSRRPSPSSRPRSPPRPPPPPPSSRSRSSRPRRPRPPPRPPPRSRRSSRSPSRSSRPRRSRSPRSPPRPPRPPPPSSRPSSRSPPSRRPPRSRPPSRRSSRPSSRSPPSSSPPSPSPPR
SSRRSSPPSSSRPRSPRSPSPSPPRRRPSPRRSSPRPPPRRPRPPPSPPSRSRPSRSSRPPRSSPSPRRPPSSRSRPSPSPRSRSRPSRPRPPPRSSSPRRPPPRSSRSSPRPRPPPPRRSPRSRRPS
RSPSSPRRPRRRRSSPRRPRSRPPPSPPRSRRPSRPSPSSPPRPPRRRSSRRRRRRSPPSSSSPSRSSPPPRRRSPPSRSRPRPSPSSSSSPRRRPPSPPPRRSSRSSPPSPRPRRSPSPRPRSRSPS
SPRPPSPSSRRSRSRPSSRPSSPSPRPPRSPRSRPSPRRSRRPPSPPRRRSSPSSPPSRRSSSPSPRRSPSRRSRSRSPPPRSSPSRPRRSSSPPRRPRRRSPPSRRSRPSPSSRPRRSSSRPRRSSS
RSRSPSPSPSRRPPPRRSPSRPSRRPSSSRPPRSRRRRRPPPRSSPSSSRPRRRSRPPPRSRRRSPRPSRRPSRSSSSSSSSSPRRPRRRPPRPRSPSSPPRPRSRSRPPRSSRSSPSSSSRRSPRRP
SPPSPRRSPSSPRSPRRRSSPSRRPPSSRSPRRSRPSPPPPPRSSRSSPPPPPPRPSPSSSRSRSPRPPRSSPRSPSPPPRPRRPRSSSPRRRRPRPSRPSRRPRPPSSRSRPRRPPPSRRPPPPRRP
PRSPPPRRSSPPPPRRPPPSSSSRRPPRSPSPSRSRSSRRPSPRRSPSPPSRSSRSRSSRRPPSRSSPRRSPRSRSSRPRPSPRSPRPPSPPSRRSPPPPRPRRPRSSPPRRRSSSPRRPSSSRSPRP
PRSSPRRRPRSSRSRRRSRRSRPPSRPRRSPPRPSRSPRPRRPSPRSSSSRPSRSRPSPPPRPSRRRPRSRPRPRPSRPPSSRPRPSPSPPRPSSPRPSRRSRRRPSSSSPPSSRPRSSRRPRSSPSS
RSPRPRPPSRSPRPPSPPRPRRSPSRSRPSRSPRRPRSPSPRSPPRRPRSRPPPSPSRRSSPPRRSPRPSSSPPSSRRRPPPSSPRPSRPPPPRPSSSSRSSRRSSSPRRPPSRPRPRPRSPPRSRRP
RSSRSSSPSRRPRSRRPRPPRPSSPSPSRSRRSRRPPPRPPPPSRPPSPPPRRRSRSPRPSPSRSSPRSRRRPRPSSPRSSPSPRPRRPPRPPRPPRPRPPRSPSSSRPSPRPSPRPPPRSPSRRSRP
PPSRSRSPSSRSRRSRSPSPPSSSRSPRSSRPRSRSSPSRPRRSSRSSSSPSSPRPPPPPRRSPPRSRSRRPRSPPPSRRRSRPPRRRSSRRSSPRSSSRRPSPSRSRPRSSSPSPRSRSRRSSRPRP
SSSSPSPRRPSRSSPSPRRSSSRRSPSSRPSRPPPSSPSRSSSPPSRPPRSPSPRRPPRRRPRSPSPPSPRRPRRRSSRRSSRPSPPPRRSRRPRPPPRRPPRPSRRRSPPPSSPSRRPRRRPSRSSS
RSPSSRSSSPSSRSSPRPSRRSPSRRRSPPPSSSRRSRRRPPSSPPSSRPRSSPSPPPSSSRPRSSRRSRSSRSPRSPPPPRRPSRRSRRPPPPSPPRSPSPSRRSPRPPSRSRRPRSSSPRSPSRRP
RRRSSPPRRPPRRPRSPPSSSRSPPRRRSPRRRPPSRSSSSRSPRSPSSRRRRRRSRPSRSPRSSSPRPSPRSRSSRRRRPRPSSRSSSSSRRPSPPSPRPPPPRPPSSPRPRPPRSSSSRRPSRPRR
RRSSRSSSSSPSSSSRRSRPPPRSPRPSRSPSSPRRSPPSSSSPRPPPRRSSPRRSSSPRSSPRSRSRPRRRSRRPPSRRPRSRRPSRSPPSPRSRSPPPRSRRPPSPRSRPSPSSSSPRPPPPPRPS
RSRRSSPRPRPRRPRRPSRSRPPSRSRPSRPSPSSPRRPRPSRSRRSPSRRRRSSPSSRRRPRRPSPRRRRSPRRRSSPSSPSSRPSSSRSSRSRPPRPSSRSPPPSRPRRRSRSPSRPPRSRSRPRR
PRPRRSRRRRRPPRRRSRSPPSRRSPPPSSPSPSPRSPPSPSPPRPSPPRSSSPPSRPSPRRSSPRSPSPPSSSPSRSSRPPRPPSRRSPRPSPPPPSSRPSRRRPRSSPSSSPPSRRRSRSSRRPSP
RRRPRSSPPSSRPPPRPRSSPRPRSRRPPSPPPSRPSRSSPSPPRRPPSPPRRRRSPSRSSPSPRRRRSPRPPRRRRPRSSSRSSPPRSPSSRRRRPPRPRPPRRSSRRPRPRPSSSPSRSSPPPPSR
PRPSSRRPRSSPPSSRSSSRSRSRRSPPSSRRPSPSRSPRSRRRSPPRPSSRSSSSSRRRSSRRPSPSSRRPPPRPRPPSPSSRSPPSSRRPRPPSSRRRSSSSPPSSPSPRPSPPSRPRSPPRRRPS
PRPPSPPPRPRSSRSSSSRSRSRSRRSPRRRPPPPPRPSSRSRRSPPPPPPRRRSSRRSRRSRSRSPPSPPRRRRRSPRPRPSRRPRPSSSPPSSPPPRSPRRPPPSPPSPRPSSRRSRSSPPSPRPR
PRRRSPPSSPPSSSRRSSRPPRRSSPPSRRSRPPPPPRPSSPPRPRPRPRRRPPSSPPSPSPSPPSRPSRRRPRSSPSRSPPPPRRPPRPSPSRPSRRRPSRRPRSRRRRRPPSSRPSPPRPRPRSPR
PRRPSSSPRPPPRSRRRRPPSSPSRSSSRRPRSPRSSRPRRSSSSPRRRSPPSPSPRPRSSPRPSRPPRSSRRSSPSPPRPSPRPSSPPRRSPSPPSSPRRSSSPPRSRSSSSRSRRSRRRRSSSSRS
PPRRPSSRRPRRPSSRPPSSRRPRPPRPPRPSRSSSRRRSSSPRRPPRSPSPRSPRPRSSPPPPSSPRPSRPPPRSRSSRPRPSRSRPSRPPRRRPPRPSRPSPPRSSRRPRPPPSRSRRSSRSSPRS
PPRRSPSRSSPPPPSPSPPSSPPSPRSPPRSSSPPPPPRRRRPPPRPPSRPRRPRSPPPPRSPSRPRPSSRSPSRSRSPRPSPPRSRRRSRPRRSRSRSSRRPSSPPPSPSPRSRSSRRSRRRPPSRP
PRPRSSSPRSRPRSSSPRRRRRPRSPRSSSPSSRSRRSSSPPSSPRSPRSSSSSSSPRRPRRSPPPPPPSRSSPPSSSSRRPPPSPSRSRPPSPRRPRPRPRSRPRSSPRSSPSSRPSSPSPSRPSSR
RRSRSSPSRRRPRSRSRRPSRRRSPPSRPPRSRRPPPSRRRPSRRSRPRPPRSSPSPRRPPSPPRPRPPRPPRSRSSRSPPRPRRPPSPPPRSSSRRSRRPSRSSPPSRPRPRRPRPPRSRRSRSSSR
RPSRRRRRRRPPSSSSPPRRPPSSRPSPRSPSSSRPSSPSSSSRRSSPSPRSSRRRSRRSSRRPSRSRRSSSPSRPPSSRSSSRSSRRSSRPSSPSPPRPSPPPPPPRRSSPSSRRSRSPRSSPRSSR
SPRPSSRSSRPRPSPRPPPSRPRPSSPSPPSRSPSSPRSRRSSSSSPRSSSRSRSRRRSRPSSRRPSRSPSRSRRSSPPRSRSPSSPSRSPPPSPRPPRSPSPPSRRSRPSSRRRRSPSRPPSPRPPR
RPRSPSPPSSPSPRRSRRPSRRSSSSPSSPRSSSPRRPSPSRPSPSRPRSPSPRRSPRPRSRPPRSPSPPSSSSSPPSSRPPPSPPRSRRRPRRPRSPSSRPSPSRPPPPSSPRSSSPSSRSSRRPRS
PRSSSRPSPPSSPRRRRSSRRPPRRPSPSSSRRSSSSPPSPRSSPRSSSPRRRRSPPSRRSPSRPRRRRRPSSSSRPPPPRSSSRPPSRRRPRSSSSRRSSPSRPPPPRRSPPRRRPRSRSSPPPRRS
PRRSSSRPRRPPPRSSSPRRSRPPRPSRSRRRRSSRRRPRPPSRSRRRRSRPPRPPSSRPSPSSSRSSSRSSPPRPPPSRPPRPSSPPRPRSPSPRSSPRRRSRRSRRSPRSRSPPRSSPPPRPRSRR
PPSPSPPRSSRSSSRPPSSPRSPSRPPSPRRRPRPPSSPSSPSSRSPSPPRRPSSRRPSRPPSSSSPRPPSSRSPRSPPRPRPPSPSPSRPSSRSRRPPPRSSPSSSPSRRSPPRPSPRPPSRPPSSR
PPSRPSRSSRSRPPRRSRPPPRSRSRSSRPSPRRPRPSRSPPPPSRPSSRPPPSPRRSPSSSPPRPRRRRSSSRSSSSRPSRPRRSRSPRSSRPRPPSPPSRSSRRSRPRRRSSRSSPPSRPRSSPRS
RPPRRRSSPSPPSRSSSRRPSPSRRSSSPPRPSPPSPRPPPPSPRSPPPRSSSRSPRRSSRSRSRRPPPPSPSSSPPRRSPPRPSRPSPPPSPRRPPSPRSRSPSPPRSPPSSSPRRRRRSRSPSSSP
PPSRSSSPRRSSPRPRSRPPPRPSSSSPRRRRPPRRPSRRPRSPRPPRRPRPRSRSRSSSPPSRSPRPSPPSPPPSSPPPSSSSSPSSPSSPPSRRRPPPRPSSSPSRSSSRRPSSRRPRPSRPRPPS
RSRSSPRSSPRSPSRPRPPPRPPRRPRRPRSPRRRRSSRSRRPSPPSRRPRRRSRRRSRRPSSPRRPSRRRSPRPSPSPPSPRPSSRSRPRPPPSSPSSSPSRPSSPRPSPRRRRPSPRSRSPPSSPP
PPPRPRRRRSRPSPPSPRRRSPSRRPSSSSRPSPRSPPRSPSRPRPRPPRRSPSPRSPRRPRRPSRRRPSPRRPRRRSSSSPRRSSPPSSPPRSPSSPPPPSRRRRPPSPPRSRPPRPRRSSRSPRSS
SPRSRSPPPPSPPRRPRRRRPSPPPPSRSRRSRRSRSPRRPRRSRRSRPRPSSSSRSRPPSPPRSRRRPRPPPPPRPPRPPPRPRPRRPPPPPSPSSPRSPPRSRSSRRRRRPPSRSRSSPPSSRPPR
RSPRPRPSRRPPSPRSRRPSPRRPSSSRPPRSSPPPSRSRPRSSPRPSSRPPPPSPPSSPRPSRSRPPRPRPRPRPPRRPPSSPSPSSRRSRRRPSPSSSPPPRPSRSPPSPSPPPPPRRSSRRPPRR
PSPPSRRSPPPRRSRSRSRSSRSPPRSSPRRSPSPSPPRSSSPSSSSPPPSRSPSSRPPRPPRPSPSSPSSRRRRSRRSPPPPRRSPRRRRRSRSRPRSRRSRPPRSSRSPRSPRRPRSSPRPSPRRP
RPSPRPSSSPPPPSSSPRPSSPSRRSSSSPRRPPRRPPRRRRPPPPSSPPPPRSSRSRSRSPSRPRRPRRPPPPPPRPRRRPRSSRRRRPRPPSRPRSSRSRPSPSRRRSRSSPPPRRRRSPRPRPPR
PSSSSRPSPRRSPRPRRSSRPRRPPPRRPRSRSRSPSRPSPPPRRSRSSSSPRRRPSPPPSPPPRPRSRRRRPPPRRRPSPPPRRRRSPPPRPRRRRRRSPSRSRPPSSPRRRRSPSPSPRRSPPRRS
PPPRSRSSSRSRPRPPPPPRPPSSRPRPRPSRRRPSPPPPRPPRSPSSRPSPPSSRRSRRPSPSPPRPSSSRPPPSPPRSSRPSPPSSRPRSPRSRPPRPPPPRRPRPRPSSPPSPSSSRRPPSRRSP
SPSRRSPPSPPPPPPSPPPPSPRPRSSSSSSRPSRPRRPRSRPPRSSPRSRPRRPSSPRSPPPPRRPRPPSSPRPPSPPPSPRPSRPRPPRRRRSSSSSRPRSPRSPPPRSSRPSPRRSRRSSPPRPS
RRSRSRSPSPSPRRRRSRSSRPSPRPRSSSRPSSRPSSRRPRSPSPRRRPPSPPSSRSSSPSRSSRRPSSSPSSRRSSSSPSRSPRPPSPSRRSRSSSSSSPSRRSRPSRSRRSPPSSRPPRRSSRSS
SSRRRRRRRRSSRSPSPRPPSSPRSSRPPPRSPRPSPSSPPRSSSPSPRRRSSRPRRPSSSSRPSRSPPPPSSSRPPPRPRSPPSRPSSSRRRSRSSRSRSPSSRPSSPRRSSSRSSSRRRPSSSRSS
RRPRRRSPPRSRPRPRSSPPSRRRPRRRPRRPPSRSPRSPSPSSSSPRSRSRPSRSRRSRPPPPRRRSRSSRSRPPPRRPPSPSRSSPSSSSPSSPRSPRRPPPRRRRRRSPPPSRPPPRRRRPSSRR
RRSSRPPRSPSRRRRPPPRPPPRSSRRSSSSRSSPPPPPPRSPSRSRSPRPSRSPSSPPSSRSPPPRRPPSPSSRPPSRRRSSSSRRSRPPSRRRRSRPPRPPRRSRSSRSSSPPPSSRRRPSRRRPS
RRPPSSPPRSPPRPSPPPPSSRSPSRPSRSSPRRSPRPRSRRSSRPPRPPPSSSSPRSPSRPSRPRPRPSPRPRPSPPRPRPRSPSSSRPRSPPPRRPRSPPPRSSRSRRRSPSRPPRRPSRSPSSRR