100 128
PPPSRRSPPSRPPPPPSSRRSPRSRRRSRSSSPSPSRPSPPRSSPPRSRSPRPRRRSSPPPPSPSPPPPSPPSPPSSRPSRRPRSRRSSSSPRPPSSPSRSSPRPSPSRPRPRRPRSSSRPSSSRSRR
SRRPPSPSRPSSSRPSPSSPPSPSRSPRSRRPPPPSSPSRRPRSRPPPRRRRSRPRSPPPRPSPPRSRRSPRRPRSSSRRPSSPPPPSRRSRPSPRSRPRPPRRSRPSRSRPRRPSPPRRPRSPPRRS
PPSSSSRRSPRRPPPRPPSRPRSPPSRRPSPPPSSRRPRRRSRPSRPSRRSPPRRRPSPPPPPSPRSPRSSRSPPRSRSPPSPRSRPRSPSPSSRPRSSSSRSRSPPPPRPPPPPSSRSPRSSPPSPP
RSSPRSPPSRRRRRSPRPRPPPRRPRPSSPRPRPPRPRRPRPPRRPSRPRSSSPSPSPPSPRPPRSRPSPRSSPRSPRRPPPRSPSPRPPPPPRSRPSPPSSRSRSRRRRRRSRPSPPPSRSRRSRSP
PSPRPSSSPSSPPPPRRRPPSRPSSRSPSRSRRSRSSRSPPRRSPRRPPRPSSRSRRRPSSSPPSSSSRPSPPRRRSSRRRPPPRPSRPSPRPPPSRPPRSRRSPSRPRRSRSSSSRRPRSPPSRSPR
RSRPRRRSSPRRPSPSPRSPSSSPRRPRPSSSRRSRRSPRPPSPSSRPPPPRSRSPPPRSRSSPSSSRSPPRSRSRRPRSSRSSPRRSSRSRPPSRPSSPPRPPRPSRSRRRSPRRSSPPPSPSRRRR
SPPRPSSPPPRPPRSPRPRSRSSPPSSRRRPRSRPRRRRRSSSRSRRPPSRSPSRSPRPSSPSPRSSRSRPSPRPRSPRSSRPSPRSSSRPRSRSRPRRPSPPSSPRSSSSSPRSRPSRRPPSRPPSP
RPPPRSSPPPRSSPSRSSPPSSPPPSPPRSSPSSPPRPRSRPRPRRRRPPPSPPPRPRSSRSPRPPSSSRSRSPPSSPRRPRSRRRPPRRRPPRPSSRPSPPSPRPRPRSPPPSPSSSRSPSPRPRPS
RPPSSRRPPRPPRPRPRSSRRRSSPPRRPSRPPSSSPPRRPSSSSSSRSSPPPRSRPPPRPSSRSSRPSPSRPPPSRPRPRPPSSPSPSPSSPPRSPRSRSSSSPPSSRRRRSRPPSSRRRPSPSRRP
RRSSSPSSSPRPPRPPPPPRSPSRSRPRRRRSPPSPRRRSRRRPRSSRRSRSSPSPRSPPSRPRRRRPRSSPSSPSPSRRSSPRRPPSRRPSPRPPPSPRRRPSPRRPSPSSPRSRSSRPRSPPRPPP
SSSRPSSRRPRRRPPRPPPPRSRPPRRPPRSPSSRPRSPRRSRRSPSSRSPRPRSRSPPPSPRPRRRSSSRPSPPSPPPPSPRRRPPRPSRRPRPSRSRPPSPPPSPRRSPPSPSPSSSSRSPRSRRP
PSSPPRPPPRRRSPSPRPSRRPPRSPRPPSPRSPSSPSSSPPSRRPRRSSRRSRSSSRRRRSRRSSPSRPRRPPRPPRRPRRSRRSSPPPPSSRRSRSSSPSPPSRRPPPRSPSRSSPSRRPRRPRRR
PPSRPRSRRRRSPRSPPSPPPRPPSPSSRSRPRRPSRRRRPPSSPRSRSSPSSPPSSRPPRRPSRRPRSPSSSRRRSRPPRRPSRPPSPRRSSRRSRRSRSPPSRRRSSPSPRRRRPRPSRSSPRSRS
RRSSPSRRPPRRSRSRSSSRSRPSRPSRSPRPPPPSPPPPPSRPRSSPPPPSPRSRPRRSPRPPSSSSSRRSSSRRRSRPSRPSRRRPRPSPRPRPPSRPRSPRRSPPRPSSRPRSPRSRRPRPPPPR
SRRRPRRRSSPRSRRRRRRPSPSSPPRPPRPRPPPPRPRPRSPSRPPPSRPRSPSSRSSSSPSRPRSRPRSSPRPSPPPRPSPSPSSRRSPPSSPRSRSPSRRPPPSSSSSPRRSPPPSPSPPPPSRS
RPRRRRPSPPSSPRSPSSRPRPPSSPPPPRRRPPSRRRSSSRRSPPPPRRPPSSRRPPPSRRRPRRSSPRPSPPPRSPRRRPSRRSRPSPRPPRSRPPPRRPPRRSSSSSPRRSPPPSSPPRPSRPSR
SRSSSPSSSRPPSRPSPPSRRSPRSSRPPSPSSPPSRPSSRRSRRSRSSSRPRRRSSSPRRSPPPRPSPPRRRSPRRRPSPPRRRSPSPRRSRSPSPPPRPRPRRSRSRPRRRRSSPSSPSSSSPRRS
RRPPRSRSPRRSRRPPSRSRSSPPSPPSRPPSRRPRRSPSSPRSPSRRRPSSRPSPPPPSPRSSPSSSRRRRPPRRRPPRRRSSRRPRPRRRPRRPSPRPPPSPPSRRSPPPPRRRPRPRSSRRSRPP
SSPPRSRPSPPPPPPPPPRPRSSPRPRPSPPSRSRRPSRSPRPPPPPSSSSRRPPRRPSRSRSRSPRPSRRSRSSPSSSPPSSSRSRRPSRRPPSPRRPSRPPRRRPSSPRRSPPRPRSSSSSPRSPR
SSRPPRRSRPRSPPPRSPSPRRSSRRSPRPPPSPPRRSSSPSPRPPPPSRSSSSSRSRPRSSRPSRRPRSPRSSRRSRSSRSRRPSPRSPRSSSPRPRPRRSSPSRPRSRPRPRPSRPPPRRPRRPRR
RPSRPPSSRSSSRSSPPSPRRPPPSPSSSRRSRPPPRSSPPPPSRRPPSSPPSRSRPSRRPPSSRRPPSPRRPSPRRSRSPPSSRSSPSRSRSSPPRRSSSPRPSRRRSSSPRPPRPRPRSPSPSSRR
PRRSSRRSSSRPSSRRSRSRRRSPRRRRSPSRRRPSPPRRPRSSRRSSRPSSSPRPPPSPSPPRSSRPRSSSSPRPSPRPSSSSPRRSSSRSPSSRPSSRSRRPPPPSRRRPSPPSSRPSRRPRSPRR
SPSSPRPPPSSPRSSPPRSRSSSSRRRPSRRPPRRPRPSPSRPSRPPSRSRRPSPRSPPPSPRRSPRPSPRRPSPPPPPRRPSSSRPPSSRPPSPRPRRRSPSSRRRPRSSPRPRRRPPRRPPSSPSS
SSSRPPPSSPSRSPRRSPSPSSSSPSPSSRRRRRPSSPPPRPSPPSPRSSSPSSSRRSRRSPRSRRSSSSRSRRRRSRPRPSSSRPRSPSSSPSPPRRSRSRRRSPRPSSRSPSPSSPRPSPSRRRRR
SSPPPSPPRPPRPPSRPRPRRSSRRRSPPSSPRSRRPPPPSPRSSRRSPPPSSPSSSRPRRPPRSPRSPSSSSPRPRSSPSRSPPPSRSRRPPPPSPSPRSSRSRPPSPPSPPRRPRRPPRRPSPRSP
PSPPRPSRPRRRSPSRPRRSPPRPPPSRPRPSPPPSRSPSPRRSRPPPSRRSSRPPPRPPSPRPSSSPRSRSSPPPRSPRRPSPSSSPSPPRPSPPSSRSRRSSRPPSPPPPPSPRPRRRRPSSSRSR
SSRRPSPSSPSSRRPPSRSPRSRRSRPSRRPSSRRSRRPPPRSSPPSPSSRRPSRSRPSPRSPRSPPRRSSSSSPSRRPRRRPSPSRSSPSPPPSRPRPPRSSSPRSRRRSSSPSRSPRRRPPRRSRS
RSSPRSRPPPRPPSSSSPSPSPPPPRSSSSSPRRRSPPSSSPSPRRSSPPSRRPSRPPPRRPPPSPRRPRRPSSPRRRRPRRRRPPSSSSRPSPPPRSRPSSPPRRRPSRSPRPPSPSRSSPPSRRPP
PPPRRRPRRSSPRSRSRSSRSRSSRPRSRSPPRRRSPSRRRSPRRRRPRRSSPRPPRRSRSSSRRRPPPRRRSSRPSRSSPSSPSSSRRRPPSPPRRRSSRSSSRSPSSSRSPPRPPSRRPRRPPSRS
RSRRRRSSRPPSRSSPPPRPPPSPPSSSRPSRRPRPPRPPRRPPPSSSRRRRRRSRSPSRSRSSRRRRSPPSPPPSRRSSSSSRPSPSSSPSSSPSSRRSSPSPPRPPRRPRRSSPSPSSPSSSSRPR
PPSRPRSSRPPRSRSRSPRRSSPSSPRPSRRSPSSPSRSSRRRRRSRSRSPSRRSPSPRRSRPPRPPSPPPRRSRSPSRRSPPRRSRRPRRSSSRRPRPSRSRPRSSSSPRPSPRRPPPRPPRRRSSP
PPRSPSSRPPPRRPPPPRRPRSPPSRRRRPPSRPRRSPPSRPRRPPSPRSPPRPSSPSSRSSRRPSPRRSPRSSPSPRRSRPRRPPSRSRPPPSRSPRSSPPRRRRRPPSRPSPSRSPRSPRSRSRRS
RPSPPSRSSSSRPPRSPPSRRPSPRSRRSRSPPPPPRRSSPRRPRRSPPPSRSRPPRPPSPPPPSPRPPRSPSRPRPSRRPRSPPPSSSRRRPSPPSSPSPSSRSSRSRPSRPSSRSSRPRPRSSSSS
PSRRSPSPSSRPPRRPSRRSPPPRSRSSRPSPPSPPPPRPRRRPRPPPPPRSRPPRPPSSPRSPSSSPSPSRPPSRPRRRSRRRPSSPRPPSRSSPSPRPSSPRPPSPSSRSSRPPRRPSSPRPSRPP
SPSPSRPPPSPSSRRSRPSPPPRRSPSSSRRPSRSRSSSPRPRSSSRRPSPPSPSRPPSRPPPRSRRPPPPPSRPPPSRPSSRPRPSPRSSSRSRSPPSSRPSRSRSPRPPRPRPPSRSRPRRRPRSP
PSSRRRSSPPRSPSRSRPRSRRRSSPSRSSRPPSRRPSSPPSRSSSPRRRSSPSRSPRRPPSRPSPPRPPRRRPRRPRRSSRSSRRPSPSRPPPPSSPRRSRRSRRSRSRSPPSSPPRPRRSRPRRSR
RSRPRRPPPPPPPPRRRSRSSPPPSSSRPRPSRPSSRSRSPRSRRPRPPPSSRSRSRSRSSPRSSPSSSSPPRSSRSRRSPPSSRPPRRRRRSRRRPRRRPRRPRSPPSRRPPSPRSPSRSRRPPSPR
RPRRPSRPSPPSSRSPSPRSRSSRRPSPSSSPRSSPPRRRSPRRRPSPPSSSPPSRSSSRSPPRPRRRPPPPRPRRPPRSRSPRSPRPRSSRRSSPRSSSPSSRPPPRRPRRRPRSSSSRRPSSRSRP
PPSSRSPPSSSRSPPSRSSRRSSSRPPSRPPRRSSSPSRPSRPPSRPRPSRSRRRSSPPRPRPSPRSRSPRRRRRRSPPPPRPPSPPPRSRRRRPRPSSSSSPPSSPSRPRRRPPPRRSRSPPRRRSP
PSRRRSRSPPPRSRRRPPRSRSRPPPSSRSRSPRSSPPSRSSPRRPRRPRPSRRPPSRSRRSRSSPPPSSSPPPRSPRPSSPPSRPRSSRRPSSPPPRRRSSPPSPPSRRRPSPSPPPSPRRSPSPSR
SSRRSSPRRRSRPRRRRPSPRRSPRRSSPPSRRSRRSSRPRPSPPRRRPRSSRPRRSPRPPPSRRPSRRRSPRSSRRPRPSPSRRRPRPSRRRRRSRPRSSRRSPSRSPRRPSPPSSRPRRRRPPSSS
SSRSRRRSRSSSSPSRRSSPPPSPSSSRPPSRPPPPPRPRSSPRSPRRRPRSPRPPPSSPRPRPSRPRSSSRRSPSRSSSSSPRPSSPSSRRPSPPSPPRPSRPSRRRPPRSRSRRPRSSPPSSPRPP
RPSSSRRRSSRPPSRPRSRSSSPSRRRPPSPPSPPRSRRSRRSSPPRPSSSSRRRRSPSRSPRRPPRSRPRSPPRSSSRSPRPSSPRPRRSPRSSRSRPPPRSRSRRPPRSSSRRRSSRSPPRSPPSS
PRSRSSRPRRPRSRPPPSRSSRSRSRSRPSPPPPSPPRPSRRSPSRSSPSRPRSSSSPRSSRPSRRRSRRRPSSPRRSSSSSRSSRRSRSRSPRPSRSPRSPPSPRPPRSRRRRSSPRRPSRRPPPRR
SRSRPPPSRPPSRRSSRPPPRPPSRRPSSSPSSRSRRSPRPRPPRSPPSRSSRRRRSRSRSRRSSSPRSPPSSRSPRSRRRRRRSPSSRSPPRRPSSRPSSRRRPSSRPSSPRRRSSPPPRPRPPSPP
SSPPSPPSSPRSSSRPPPRPPPRRRRRPRPRPSPSSSRRSSRSPRSPPPPRSSSPSSSRSPRSPPSRSRRRRPSPPPPPPSPPPPPRPRSPPPRSPSSSPRRRSSSRRPSRRSSPRPPRPPRSRRPPR
SSRRRPPRSSPSSRSRPPPPRRSPRRSPRSRPPRSPSRPPSRPPSPSPPRSPPPRSRSPPPRRPRRSRSPRPPPRPRPRPRSRPRRRSRSPPRPSPSSSSPPRRRPSRSPSSPSRSRPPRRSPRSSPS
PRRRRSRPPSSSRSPRSPPRSPPPSPPRSSSRPPPSRRSPSRSRRSPSSSSSPRRSSSSSPSPRPRRRSSRSSSSSRRSSSPSPSPSRRPSSPPSSPPRPSSSRSPRPPPPSRSRPSSSSPSRPRSSR
SPRPRSRSSSPSSSPSSPSPSPRRSSRSRSSRSSRRSSSPRPRPPSSPPSSPSRPSRRSSRSSPRPSPPPSRSPPPPSPRPRRPSRSPRPPSPRPPPPRRPPRSRSSPRSSPSPPRSPSPSRSPPPPS
RSPRSSRSPSRPPSRSSPRSPSPPPSSPPSPRSRPSSRPSRRPPSPRPSSSRRRPSPPSRRSPPSSRSPRPPSSPSSRPSSSRRSPPSRPSSRSPSRRRRRPPSRSPPPRRPRRRSPRRPRSPRRRSR
RRPSRSPSPRRSPSRPRPPPSSRPRSPPSSRPPRPPPPRSPRRRSPPRRRPRPPRSRPPPRSSRRPSPSSSPRSRPSPRPSRPSRSRRRPSRSRRPPPSRPSRPSRRSRPRPPRRRSRRSSRRSSPSR
RSSSSRPRSSRSSPSPPPRRRPPPPPPSRSPRSRSSPPRSSPRSRRRPSRPSSPPRRRRRPRRRSSSSRPPSPSPRPRSPRRRRPRPPSRRRRRRPSPPPSRSRPRPRSRRPPPPSPPRPPRRPSPPS
RPSSSPRRPRRSSRRRRPPPPRPRRSRRPSRRRRSRPRSPSSPRPRSPSRSRPRSSSPSPSSPPPRRSPRRPPSPRSRSSRSPPPSRRPRPSPRPRPRRSPRPRRPPRRSRPSPPPRRPRRRPPRPPP
RRRRRPPRRRPPPSRRSRSPPSSPRRSSSRPPSSSPRSPSPPPSRRSSSPPSRRRPRRSSPSPPPRRPRRSRSRRPRSPRSSRPPPSRRSSRSPPPRSRPSSSSSPSSPSRSPSPRRPPRPSRRPSSR
RPPPSRPPRSPPSPSSRPRPSRRRSRSPPPSRPSSSSRRPSSPPRSPPSRRRRPSPSSPPPRRSPSPRSRRPSPSSRRSPPSPRPPPPRSPSSSPSPPSRSSSPRSPRPPSSRPRPRRRPRPSPPPPS
PPPRRSRRPRPSSRRRSSPPPPSSSRRSRRPRRPPSPRSRPSRPPPRSPSPSSRPRSRSPRPRSSRRPRSSPSRRPSSRPPPPPRRPSPSPRRSRPRSSPRRSSPSPPSRRSPPRPPRPSSRPSPSPP
PPPRPRPRPSSRRRSPRSSRPSPRRSSSSRRPPSPRRSSRSPSSPRRPPSSRSSSPSRSPSPPRSSPSSSPRPRRPSSPRSPSPPSSRSSPSRRRSPSPPRRRPPPRPSPRSPSRSRSPRRRSRPPRS
SRSPPPSSRSSRPSRRSSSRSSPPPPRSPRRSRPRRRSPSRPRSRRSSRPRRRSPPPRPPRPPRPPPRPPSSPRSRPPPPRPPRSSSRPPRSRRRPPSSSPRSRPRRRSPPSRRSPPRPSSSSPRPPP
RPRSSRSSRPSSPPPPPPRSRSRPRSPRPPRPPPSRRSSRRSRRSPSSRPPPSPRRRPSSSPPRPSPRSRRRPSRPPRPPPRRPPRSSRRPSRSRSPRRPPPRRSSPPPPPSRSRPPRPPRPRPRRSP
PRSRSSPPPSRRSRRRPSPRPPPSSRSRPSPSPPPPPRPRPPSRPSRRRPSPRSSRRRPPSSRPSPRRRRSSPRSRPRPRPRRSRSSPSRPSRSSPSSSSSPPRSSRRPRSPRPPRPPRPSRRRPRSP
SSRPSSRSRRSPRPSSRRRPPPSRPPSPSPRPRSRPPSPSRSSPSRRRSSPSSPRPPSPRPSRSRRRPRSSPPRSPRPSRPRPSPRRPSRRPRSSRPRRRPRSPSRRPPPRRSSPSRPRPRPRRSPPR
SPSRRPRPRSPRRSSSRRRSPSPRSRSPRSPRSRSSPRSSPRSRPSPRSSRSSPPRPSRPRPSRPRPRRSPPPSRPSRSSPPSRRRSPSPSPSPRPSPRSRSRPRPSRRSSSPPRSPSRSSPSRPRRP
RRSSRSPPSSRPPSPSSPRPRRSSRSSSSSRSPRPSPPPPRPPSSRPPPSSSRPPRRPSPPSPRSSPRPRPRSRRRPPSSSRSRSPRRSSSSRRRPPSPPRRSRPSRPPPRRRRSRPPPSRRPSPPRS
PRRSRSSSRPPPSRRSRRRSPPPPSSPRPRRPSSPSSSPRSPPPRRPPRSRSRSSRRSRPPPSPRSSSSPSSSPPRPRRPPRRPSSRPSSRSSPRPPPPSRSSSPRRSRSRRSRPPPRRRRPRSRSSP
SSSSRRRSRSRSPRRRPSRRSPPRPPPPSSRPRSRSPRSPSRSRSPPSSPPPRSRSSRSSRSSRSRPPPSPSPSSPSPPPRPPSRSRSRRRSPRRPSRPPRRPSPSPRRSSRPPPRPSRRSRRRRPPR
RSPPPRSRRRPPPSSSRSRRPSPSPRSRRSRRSPPRRRPSRPSPSPSPRRRSPSRSSPSSRRPPSPSSRSSPRRRPRPPSPPSPSRPRRSRSSPSSSRRPRRPSRRSPPPRRPRRRPPRRSRPPRRRS
RPSSSSRSSPRRPPPRPSRPSSSSSPRPSRSRPRRPPRPPSSRSRPSSRRPSSPRSPPPSRRSSPSSPPRSRRSPPRPSSPRSSRSPRSRRPRRRPSRPRPRSRPPRSSRPSPRRSSRSSRSPRSPSP
SPPPSPRSPRPRRPRRPSSSRRSPRPSSRSPRPPPPPRRRSRRPPRPSPPRPRPPSRPRPRPRPSRRRSPPPPRRRRRSSSSPPSPPRRRRPSRRRSSSPRPSRRPPRRSSPRSPSPPRSRPSSPSSS
SRSSSPSRSPSRSSRPSSPPPRRSRSSRRPRPSSSPRSRRSSSPRPRSPPRRPSRPSSPRSRRRPPPSPSRSSRPRPSRSRSSRSSSSPPRPRSSRPSRRSRPRRRSRPRPRRPRSSSRRRSSRSSPR
RSSRRRSSPSSSRSSSPRPRPSPRPSSSPRRRRPPRRSRSRRSPRSRSPPRPRPSSSRPSRPRSPSPPSRSRRRPPPPSRSSSRRPSRRSSRPRSPRRSPRRSSSSRRSPRPSRRPRRRPPRRSSPRR
PRSPSRPRRPPPRSRRRRSPSRRPRPRRPSPRSSRSSSSSRRRPRPRSRPSPRPPSRRSSSSRRSPPRRPRPRSRSSSPPPRSSPSPRPSPRPRRSSSSSRPPRPPSPPPPSSRRPPRSSRSSPRSSS
RRRRSRSPSRPRSRSRSRRPRRSRRSRPPRRRSSPPRPPPRRPPSPSPRRSSSRSPPRPSRRRRPPSPRSSSRRPRSRRPRRRPSRPPPRRSSRSPPSSSRPRRRRRSRSSSRPRPRSSRPPPSSRSS
SRSSRSSSSSSPPSSSRPSPRRRRPPPSRSRRRRRRRRRPRPRPPRRPSSRPSSPPRPPPRSSRSSRPSSSSSRRSSPPRSPRRSPPRSSPRPSRRRRPRPSPSPPPPPSSSSRRSRRPSPPRSSSRP
PSSSRRRSRRSPSRPPPSRRPSRPRPPPPPPRSRRSRPPSSSSRRRRPSSPRPPPSSRSRRPSPRRRRSPPRRSPPSPRPRPRSRPSSSPPRSSPRRRRSRRPSSPPPSRRPSPSRSRPRPRPRPRPS
SRPPPRSRPRPRPSPSPSPSPSRPPSSRRPRRRRSRPSSSRRSSPSPSRSRRRPSPPRRRRRSSPSSRSPRRSRSPPRRPSSRRPPPPSPSPRRRPSSSRPPRPPPPSRSSPPPRRSRPSRPSRRSSR
SRSRSPRPPSSRSSRPPSRRSSRSRRPSPSPRPSRPRPPRSSRPPPRSRSRSSSRPPSSRPRPPRRPRSPPRRSPRRRRSPSPSRPSPSRPPSPSSSRSSPRPRSRPPRRPRRSPRRRSPPPRRPRPP
PPRSSSPRRPPSPSPSSSRRSRPSSRSSPPSSRRPRPPRPSRPSPPSSSSSRRSPPSSSPRPRSPRRSSPPPRRPSSRPPPSPRSSRPSPSSPSPPPSSSPPSPRPPRRPSPSPSPRRSPSRRPPPSP
PPSPSSSSPPPSSSPRRSPRPRSRSRPSSRRRSRPSPSPSSPSSSPRPSRRPSSPPRRRPSRPPPSRSPSSRRRPRSPRSSRPPRRSRRRRRPPPPRRSRSPSSSSSRRSRRPRPRPRRRPRRRSRPR
SPPPSRPPSSPSSRSPSSPRPRPRSRRRRPPPPPSSRSRSPSSRPPRSSRSRRPPPPPPSRRPRSPRRRPSSRRRPPSSRRRRRSSPSPRPSPSPPSSSSSRRPSPPRSSSRPRSPSPPPRSSRPRPP
SPRSSSRRRRRSRRRSPPSPRPPPSRSPPPPPPPSSRRRSRSSRPPPSPRRSRRSPSPPPSRRSSRRPRSRRSSPSSRRRRRPRRPPPSPSSRPSSPSSRPRSRRPSPSRSRRSSPSSRPSSSSRRRS
RRPPPSPPSPSRSPPSPSSPSSSPSPSSRRPSSRRSRSSPSPSPRRSPPRPRSRRSRPRRSSPPSPRRSPPRSRRRSPPSSSPPRSRSSRPPSPRSSRPSRRPPRRPSPSPSRPPRPPSPRRPSSPRS
RRSPPPPPRPRRSPPRRRSRSPSPRPSSRSRRSRRRSSRRPPSPSRPPPSSSRRRRRPRPSRPRPPPPSSRSSSRPPRPPPPRRPPSPRRRPRRRSPPPPPPRSPPRSSSRRPSRPSPSRSSSSRRRS
RPPRPSPSRPPSRRRRPPSRPSRSSRRPRSSSSSRRPRRSRRPPSSSSRRSSSPPSRSRSRSRSSRSPPRSRRRSSPRRRSRRPSSPPRRRSPPPSSRRSPRPPPRPSRSSRPPPRRPPPPRRRSSSS
PRPSSRRRRSSPPRRRSPRPSRPSSPPRRPSRPSPSSPRRPSPSRPSRRPSPRSRSPSPSSSPSRPPSRSSPRSPRPSPPRRPPRSRPPPRPPSSSSSSPRSPSPRSSSSRRPRSRSRRSRSPPRRPS
PSSRSSSSSPRRPSRPSSPPPPPSSRSSRRSPRPRRSPRRRRSRRPRSPPRRRRPPSRPSSSRSRPSRSSPSSRRRRPRPPRPRSRSSSRSRPSRSPRRPPPRPRSRSSPPPRPRSSRRSPPRSPSSP
PPPPPRPRPSPPPSPRPSRPSPRSPSRRPSPPSRRPSRPRRPRRSPPSPRRRPSPPRSRRSPPRRSPPSPSRPPRSSRRSRPSRRRPRRRRPPSPPRPRSSSRSRRRPSRSPRRPSRRPPRPSRPSRR
RSPSPSRRSRPSPPRPSPPSPSPPRSPPSRSRSPSSRSRPSRRPPSRPSSPRPRRRRSRSSSPSPPRRRRPSPSPPPSPPRSPRRPPPSPPSPPPSRRPRRRRSSRSSPSPSSRRPPRSPSSSSSPSS
RSRSRPRSRRSSRSRSSRPSRPPSSPSRPRPPSPPSSRPSRRRSSSSPSPRRRRPPSRSSSPRRSRRPSPRSPSSPPRRSPPRRSPPPSPRRPPSPSRRRRSPRRRPPRSRRRRPPSSRSRSSSRRRR
RPRSPPRRSRSPPPRPSPSRRSSPPPSRSSSRPPSSPPSSSPRSSRSPRSSSPRSPPPRSPRSSPRPPSSSPPRSRSSRSPRPSSSSSRRSRPRSRRPRPRPSSRSPRSRRPRPSSPPRRSSRSSRRR
PRPRPRSPRRRPRPRPSPPRSRSPRSPPPRPRRPSSPSSPPSSPSPRRRRSSSPRPRSSRSPSSRSPRRPRSPPPRSPPPRSPRRRPRSPSRPSSSSPPPSSPPSSPPPPSSPPPPRSRSPSRPSSRS
SRSSSPPSPPPRSRSRSRPSRPRPRRPPSSRSPSRPRRSRSSRRRPSSRRPSRSRPRRRRPSPPSPSSPPRPRSPPPRPSRSSRRRPPSRRRPRSRRSPSSPPPRPRSPPRSRPRRRRRRSPSSPPPP
RSSSPPSSSRPPRPRSSPSPRSPSPPSSRPPRRPPSRPSPRPSRSPPPSSRSPPPPRSRSRSRRRRRSSSSRPSPPPRSRSPRSPRRRRPPPRPSRPRPRSPPRRRRSPSRSPSPRRPRSRSRPSSPP
RPRRRRRSPPSPPRPPRPSRSPPSSSSSPSSRSSRRPPSRRPPRRSRRSSRSSPPPPPSPPRPSRPSSSRPRSPPSRRPSSPSSSSSRSPSSPPRSPPSSRSRPSPPRRRPRPRSRSRPPSRRRSPPS
RSSPPSPRPPRSPRSPRSRRRSPPRSSRRSPRRPSRRSPSSRPSSSRRSRSSPRRPPPRRPSRSRRSSRPPPPPSRSRRRRSPRSSRPPSPSRPRPPRSRSSRPRPSPSRPPSRPRSSPRPRPPSSRS
SRPSPSPSSPPRSPPSSRPPRRSSPPRPSRSSRSSSRPSPRRRRPSRPSPRSRRPSRSRRRSRRRSSRPRRPRRSRSRPRPPPSRRSRSRPRSRPPRSSSRPRPRRPRRRPPPPSPSSSRRSSPPPSR
RRPRRPPSRPRSPPPRRRRPPPSSSRPSSRPRPRRPSPRRSSSRPPRPSPSSSRPPPPPSRRSPSRRRRRPRRPSSSPSRPPPPSSPRRPPSSRRRPPSPRPRSPRSSRRSRPPPSSRSSRRSRPPSP
PSRSPRSRSPRSRSSPRSPSSSRSRPSSRPPRRPPSRRSPSPSSSPSSSRRPSRRRPPPRRPRRRSSSSSSPPRPSPRPPRRRPRRRRSRRSSPRSRPSSSPRSPSRRSPRRRPSPRPSSRPPPPRPP
SSRPSRPSRSRPPRPPRSPSRPSRRSPRPRRSPPRSSRRPPPRPRSPSSRRRSRSSPPPPPRPSRPSRRPSPRPSRPRRPRRRPRRSSRSRPRRSRSRRPSSPSSRRSSRRRRRPSPPSSSSSSSPRP
PPRRSRSRRRSPPPSRSPPRSRPRPSRPPSSRSSSPSRPPRPRSRSPSPPRSSPPSSRSPSRSPPRPRSSPPSRSSSRSSSSSRPPPSSRPSSSPSRSSSPSPRSSSRPSSRSSRPSSRRPSRPRSSR
SRRRSSRPRSSPRSPSSSRSPPSSPSPPPSRPSRSPRSPRRSPSRSRRPRSRRPSRRPPSRRSRSRRSRRRPSRRPSSPSSPSSPPPPSSRPSRSPRPPPRRRSSPPSRPRRPSPPSRRSPSPPSSRP