50 32
RSRRRSPPSRPSSPSPSPSRPPSRSPRPSSRP
PSRPRSRPSSPPRSRRRSPRPPRSPRRSRPPS
SRPRRRRPSSRSSSSPPPRRRPPSPPPRPSRS
RSRRSRRSPSSSSSRSSRRPPPRPRRSRSRRP
RSPSRPPRRSPPRPSSRPSPPSRSPSSRRSSR
RSPPRRRRSPPSPSPPPRSPSRSRSPPRPRRR
PSPPSRPRRSSPSSPPRRPRSSSSSSRSRRPS
SPPPRSSRRRRSPSPPPPSRPRRSSRRSSPPS
PSSPPPPRPPRRRRSPPPPSSPSPSPSPPRSP
SPPSRRRPSPSPSRRRSSSRRRPPSPSPPRRP
SPRPRPPSRPRRSSPPPSSRSRSSPPSRPPRR
SPSSSRPRSSPPRRRRPSSSSRSPSRSRSSRR
SSPSRSSPPPSPRPRSSPSSPPPPPPRSPPRR
SPRPSSPRRRSPSRPSRSRRPRSPSPRPSSSS
SPRRRPSPPRRRSRPSRPSPRSPSRSPRPSPS
PPRPPSPPSSSRPSPPSRRPSPRSRPPRPPRS
SRSPPSRPPSPPSPPPSSPPPSRRRSSSSRSR
SSPRPSPSSSSSRPSPSSPSSPRSSSSRPSRP
RPRRPSPSSSRPPRPSSSSPPSSSPPRRRSSP
RRSRRPRSPSRRRPRPRSPRPSPRSRRSSSPR
RPSPPRRSPPPPRPRRSSRSRPSSPPPRSSPS
RSRRSRSSPPSPRSSSRRRRPPSSPPPRSPSP
SRPPRRSSRPSPPRRRSSSSSSSPPPRPSPSP
RRSSPRSPPRRRSPRRSRSPRSPSSRSPRSRP
RRPRSPSSRRRSRPPRPSRSSRRRSRRPPRPR
RSPPPPSRPSSPSRRPRRRSSPPRRSRSRSPR
RRRPSSSPSSPPRSPSSRSRRPPPPPRPSPSR
PPPRSRPRRSRRPPPPPPPRSPSPSRPRSPSR
PRRRSRSRRPPSSSPPRSPRRRPSPSPSPSRP
PPSPPRRSPSSSPRRPSRSRRPPRRRSSPSSP
SPSSRSPSPRSSPPRRPSRPSPSRPRSSRPRP
PPRSRRRRRSRPPRSPRSSPRSPPRPSPPPPP
PRPPRSPPPRRRSRRSSPRPSPRPPSPRSRSR
PPPSRPPRSRSRRRPPSRPRSSSPSSRSSSPS
SRSSPRSRPPRPRRSPRSPRSPRPSSPPRSPP
RPSPSSPPPSSRPPRRSRRPSSPSPPSSRRSR
SRPPPRPRPPRPPPRRRPPRPPPPRSSPRSRR
SRPRRPSSRPRRSSSSSPRSRRPPRRSPPSRP
RSPRSSPRPRPPPRSPPPSPRSRRPRSRSSRP
RSSSPSPPSRPSSPSPPRPRRSSRRRRPSPSP
PPSSPPSPSRPRPPSRPRRPPSPPPPRSSPSP
SSRPSSPRSRRRSPPRRSSPRRRPPRPRRPRR
RRRSRSSRSRPSSPPPSRSSSSRRSPPPRSSP
PSPRPRSPRSSPPPRRSSPPPRRRPSRPSSSP
SSSSRRPPPSSRSSRRRSRPPRRSRSSRSRRP
RSRRSSSPSSSRSRPPRSRSRPPSPPRSPSRR
SSSPSPSRPSRRPPSRPRRRSSSSRRSSSPRP
SPRPSRPPSRSRSRPSRSSPSRSRSPRPPPSR
PPSPRRPPRSSRPPPRRSRRPSSPPRRPRRSP
RRPPRPSRRRPRSPRSPPPSRPRSRSPPSSRP