50 32
PRSPPRRSPPRSRRPSRPSSSPPSRPSRRPRS
SSSRSSPRPPRPRRPRPRRRPPSRPPPSRRPR
SSRSPSRPPRSSRRRPPRSPSRRSRSPRPPPR
SPPPSRSSSRRSSSSSRRRRRPRRRRPPRSPR
SRPRPRSRRRRSRRRSRSRRPSPPSSPRSSSR
PPSRPSPRRRSPPPSSRSSPRSSSPSPSRRPP
PSRSRRRSPPRRRSSSPSRRRRRSPSPRSRSS
SSSPPPSSRRPPPPSSSPSPSRRSPSSRRPRP
PSSPRRRRPRPSSRPPRSSRPRRSRPRPPPRP
SPRRRSSRRRPRPPRPRPSSRPSPRSRRPSRS
PSPSSPRSSSSRPSPPRPRRRPRPRRSSSSSR
SSRPRSSSRRSRPPSRRSPPSRSPRRRPRSPR
SPSPPRRSSRSRRSPSRPPSSPSSRPPSSSRR
SSRPRPSRPPRPPPSSSPRPSSPSPSPSPPSP
RRSRRPPPPRRSPSRPPPSRRPPRRPPSRPSP
SPRPSSPPRPPRSSRSPSPSSRRPSPSSSRRR
PPPPPRSRPPRPRPSRSPRRPPSPRRSSPRPR
SPPPPRSSRRRPRSRPSSSRSPRSRSPSSSSP
RPRSSRPRSRSPRPRPPSPRRRRSSPRPSSRS
SRSPPRRRSPSPPRRPPPSPRSPRPPRPRRSR
SSSSRSRPSSRPSSPRPPRPSPSPRRPSPRRR
PRSRSPRSSSSSRPPRPRRRPPRPSRPPPSRS
RSPSPRSRPRRRPRRPSRRRPPPSRPPSSPRP
PSSPRSSSPPPRRRSSPPSPSSSPPSPRRRSP
RSRRPPPPPRSSRPRPPRPPRPRRPSPSRSRR
PRRRPRSRPSRPPSPPRPPRRRPPSRRSRRRP
RPSRPRSPPPPSRSSSRSSSSSRPPRPRRRRS
PRRPSRRRRRSRSSRPPRSPRSPRPPRSSSSR
SPPSSSRRSPPPSRSPRPPRSPRSPSRSRRPS
RRRSRPSRPPPRSPSPRPSPRSSPSRSPSRRS
RPSSPPRSSSSRRPRRSRRPSSPSSPPSRPPR
SSSRPRPPRSSPPRSSPPSSPRSPSRPRSSRR
RPRRPPRPSSRPRRRPPRPPRSPPPPSRSRPP
PRPRPSSSPSSPPPSSSPPSPRRPRRPSRPSP
SPSRPSSRPRSRPRRRPPRRSPSRRSSSRRPP
SPSRPSPRRPPPPSSPSSRSSPSRRPPSPPSP
PRPPPPPPPPRPRSSRPPRPSPPSSSSSSSSR
PRRRRPSPRPRRPRPPSSSSRPSRSRSPSPPS
RSPPSSPPSPSPSRRSSPSRSRPSSRSRSRSP
PRRRSPPRPSSRPPSSRRSPRRPPRPRRRPSS
PSPRSRSRPPRSRSRSPPSPPSSSSRPSRSPR
PSRPSPSSRRSRRPRRRRPPSRSSSSPPRRPP
SPRSRRRRSSPPRSPRRPPRPSPSPSRSRPRP
RSSRPSPSSRRSRRPSPSPRPPPPRRPRPPSP
SSPRPSRSSRSRRPRPRSPSSPRRPPPRRSRS
SSPPPSPPRPSSSPSRPRRSPRSRRSSPSSRS
PPSPSPPSPSRRSPRSPRRSPPPPPSPSRRPP
RPPSPRSPSRPSPRRRSPRRRPSPPSSSRRSS
PSRRRRRSSPPSPRPRSRPSRPPPPPPRRRPR
PPRSPRPSRRRSSRSRPPSRSSPPPSPRRSSS