PRRRRRRRRRRRRRRRPRRPPPPSSSSSSSSS
PRRRRRRRRRRRRPPPPPPPSSSSSSSSSSSS
PRRRRRRRRRRRRRRRPRRRRRSSSSSSSSSS
PRRRRRRRRRRRRRRRPRRRRRRRPPPPPPPS
PRRRRRRRRRRRRRRRPRRPPPPPPSSSSSSS
PRRRRRRRRRRRRRRRPRRRRRPPPPPPPSSS
PRRRRRRRRRRRRRRRPRRRRRRRPRRRPPPS
PRRPPPPPPPPPPPPPPPPSSSSSSSSSSSSS
PRRRRRRRRRRRRRRRPRRRRRPPPPPPPPSS
PRRRRRRRRRRRRRRRPRRRPPPPPSSSSSSS
PRRRRRRRRRRRRRRRPRRPSSSSSSSSSSSS
PRRRRRRRRRRRPPPPPPPPPPPPPSSSSSSS
PRRRRRRRRRRRRPPPPPPPPPPPPPSSSSSS
PRRRRRRRRRRRRRRRPRRRRRRRPRRSSSSS
PRRRRRRRRRRRRRRRPRRRRRRRPRRRPRPS
PRRRRRRRRRRRRRRRPRRPPPPPPSSSSSSS
PRRRRRRRRRRRRRRRPRRRRSSSSSSSSSSS
PRRRRRRRRRRRRRRRPRRRRRRRPRRSSSSS
PRRRRRRRRRRRRRRRPRRRRRRRPRPPPPPS
PRRRRRRRRRRRRRRRPRRRRRRRPRPPPSSS
PRRRRRPPPPPPPPPPSSSSSSSSSSSSSSSS
PRRRRRRRRRRRRRRRPRRRRRRRPPPSSSSS
PRRRRRRRRRPPPPPPPSSSSSSSSSSSSSSS
PRRRRRRRRRRRRRRRPRRRRRRRPPPPPPSS
PRRRRRRRRRRRPPPPPPPSSSSSSSSSSSSS
PRRRRRRRRRRRRRRRPRRRPPPSSSSSSSSS
PRRRRRRRRRRPPPPPPPSSSSSSSSSSSSSS
PRRRPPPPPPPPPSSSSSSSSSSSSSSSSSSS
PRRRRRRRRRRRRRRRPRRPSSSSSSSSSSSS
PRRRRRRRRRRRRRRRPRRRRRRPPSSSSSSS
PRRRRRPPPPPSSSSSSSSSSSSSSSSSSSSS
PRRRRRRRRRRRRRRRPRRRRRRRSSSSSSSS
PRRRRRRRRRRRRRRRPRRPPSSSSSSSSSSS
PRRRRRRRRRRRRRRPPPPPPPPSSSSSSSSS
PRPPPPPPPPPPPPPPPPPPPPPPPPPPPPPS
PRRRRRRRRRRRRRRRPRRRRRRRPRRPPPSS
PRRRRRSSSSSSSSSSSSSSSSSSSSSSSSSS
PRRPPPPPPPPSSSSSSSSSSSSSSSSSSSSS
PRRRRRRRRRRRRRRRPRRPPPSSSSSSSSSS
PRRRRRRRRRRRRRRRPRRRRRRRPRPPPPSS
PRRRRRRRRRRRRRRRPPPPPPPPPPPPPSSS
PRRRRRRRPPPPPPPPPPPPPSSSSSSSSSSS
PRRRRRRRRRRRRRRRPRRRRRPPPPPPPPPS
PRRRRRRRRRRRPPPPPPPPPPPPPPSSSSSS
PRRRRRRRRRRRRRRRPRRRRRPSSSSSSSSS
PRRRRRRRRRRRRRRRPRRRRRRRPRSSSSSS
PRRRRRRRRRRPSSSSSSSSSSSSSSSSSSSS
PRRRRRRRRRRRRRRRPRRRRRRRPRPPPSSS
PRPPPPSSSSSSSSSSSSSSSSSSSSSSSSSS
PRRRRRRRRRRRRRRRPRRRRRRRSSSSSSSS