PRRRRRRRRRRRRRRRPRRRRRPSSSSSSSSS
PRPPPPPPPPPPPPSSSSSSSSSSSSSSSSSS
PRRRRRRRRRRRRRRRPRRRRRRRPRRRPPSS
PRRRPPPSSSSSSSSSSSSSSSSSSSSSSSSS
PRRRRRRRRRRRRRRRPRRRRRRRPRRPPSSS
PRRRRRRPPPPPPSSSSSSSSSSSSSSSSSSS
PRRRRRRRRRRRRRRRPRRRRRRRPRRRPSSS
PRRRRRRRRRRRRRRRPRPPPPPPPPSSSSSS
PRRRRRRRRRRRRRRRPRPPPPPPSSSSSSSS
PRRRRRRRRRRRRRRRPRRRRRRPPPPPPSSS
PRPPPPPPPPPPPPPPPPSSSSSSSSSSSSSS
PRRRPPPPSSSSSSSSSSSSSSSSSSSSSSSS
PRRRRRRRRSSSSSSSSSSSSSSSSSSSSSSS
PRRRRRRRRRRRRRRRPRRRRPPPPPPPPSSS
PRRRRRRRRRRRRRRRPRRRRRRRPRRRPRSS
PRRRRRRRRRPPPPPPPPPPPPSSSSSSSSSS
PRRRRRRRRRRRSSSSSSSSSSSSSSSSSSSS
PRRRRRRRRRRRPPPPPPPPPPPPPPPPPPSS
PRRRPPPPPPPPPPPSSSSSSSSSSSSSSSSS
PRRRRRRRRRRRRRRRPRRRRRRRPRRPSSSS
PRRRRRRRRRRPPPPPPPPPPPPPPPPPSSSS
PRRRRRRRRRRRRRRRPRRPPPSSSSSSSSSS
PRRRRRRRRRRRRRRRPRRRRPSSSSSSSSSS
PRRRRRRRRRRRRPPPPPPPPPPPPPPPPPPS
PRRRRRRRRRRRRRRRPRRPPPPPPPPPPPSS
PRRRRRRRRRRRRRRRPRRRRRRRPRSSSSSS
PRRRRRRRRRRRRRRPPPPPPPPPPPPPSSSS
PRRRRRRRRRRRRRRRPRRRRRRPPPPPPPPS
PRRRRRRRRRRRPPPPPPPPPPPPPPSSSSSS
PRRRRRRRRRRRRRRPPPPPPSSSSSSSSSSS
PRRRRRRRRRRRRRRRPRPPPSSSSSSSSSSS
PRRRRRRRRRRRRRRRPRRRRRPPPSSSSSSS
PRRRRRRRRRPPPPPPSSSSSSSSSSSSSSSS
PRRRRRRRRRRRRRRRPRRRRPSSSSSSSSSS
PRRRRRRRRRRRRRRRPPPPPPPPPPPPPSSS
PRRRRRPPPPPPPPPPPPPPPPPPPPPSSSSS
PRRRRRPPPPPPPPPPPPPPPPSSSSSSSSSS
PRRRRRRRRRRPPPPPPPPPPPPPPPPPPPPS
PRRRRRRRRRRRRRRRPRPPPPPPPPPPPSSS
PRRRRRRRRRRRRRRRPRRRRPSSSSSSSSSS
PRRRRRRRRRRRRRRRSSSSSSSSSSSSSSSS
PRRRRRRRRRRRPPPPPPPPPPPPPPPPPPPS
PRRRRRRRRRRRRRRRPRRRRPPPSSSSSSSS
PRRRRRRRRRRRRRRRPRPPSSSSSSSSSSSS
PRRRRRRRRRRRRRRRPRRRRRRPPPPSSSSS
PRRRRRRRRRRRRRRRPRRRRRSSSSSSSSSS
PRRRRRRRRRRRRRRRPPPPSSSSSSSSSSSS
PRRPPPPPPPPPPPPPPPPPPPSSSSSSSSSS
PRRRRRRRRRRRRRPPSSSSSSSSSSSSSSSS
PRRRRRRRRRRRRRRRPRRRRRPPPPPPPSSS